MESE,ANNO,TIPO SOGGETTO,TIPOLOGIA CERTIFICATO,BOLLO,ESENTI DA BOLLO,TOTALE
11,2021,AIRE,CITTADINANZA,296,191,487
11,2021,AIRE,CONTESTUALE,914,814,1728
11,2021,AIRE,ESISTENZA IN VITA,3,0,3
11,2021,AIRE,MATRIMONIO,222,270,492
11,2021,AIRE,NASCITA,448,380,828
11,2021,AIRE,RESIDENZA,648,695,1343
11,2021,AIRE,STATO CIVILE,11,4,15
11,2021,AIRE,STATO FAMIGLIA,364,410,774
11,2021,AIRE,STATO FAMIGLIA CON RAPPORTI PARENTELA,2,0,2
11,2021,AIRE,STATO FAMIGLIA E STATO CIVILE,4,2,6
11,2021,AIRE,STATO LIBERO,3,1,4
11,2021,AIRE,UNIONE CIVILE ,0,4,4
11,2021,Residenti,CITTADINANZA,4969,3810,8779
11,2021,Residenti,CONTESTUALE,52354,54333,106687
11,2021,Residenti,CONTRATTO CONVIVENZA,24,11,35
11,2021,Residenti,ESISTENZA IN VITA,4463,4939,9402
11,2021,Residenti,MATRIMONIO,14118,21304,35422
11,2021,Residenti,NASCITA,21977,29833,51810
11,2021,Residenti,RESIDENZA,40067,51724,91791
11,2021,Residenti,RESIDENZA IN CONVIVENZA,47,63,110
11,2021,Residenti,STATO CIVILE,11072,11855,22927
11,2021,Residenti,STATO FAMIGLIA,35622,48868,84490
11,2021,Residenti,STATO FAMIGLIA CON RAPPORTI PARENTELA,12199,15359,27558
11,2021,Residenti,STATO FAMIGLIA E STATO CIVILE,11156,13996,25152
11,2021,Residenti,STATO LIBERO,5465,3732,9197
11,2021,Residenti,UNIONE CIVILE ,178,158,336
12,2021,AIRE,CITTADINANZA,155,104,259
12,2021,AIRE,CONTESTUALE,451,306,757
12,2021,AIRE,ESISTENZA IN VITA,4,0,4
12,2021,AIRE,MATRIMONIO,177,140,317
12,2021,AIRE,NASCITA,308,242,550
12,2021,AIRE,RESIDENZA,426,401,827
12,2021,AIRE,STATO CIVILE,6,2,8
12,2021,AIRE,STATO FAMIGLIA,230,216,446
12,2021,AIRE,STATO FAMIGLIA CON RAPPORTI PARENTELA,0,2,2
12,2021,AIRE,STATO FAMIGLIA E STATO CIVILE,4,2,6
12,2021,AIRE,STATO LIBERO,2,0,2
12,2021,AIRE,UNIONE CIVILE ,2,3,5
12,2021,Residenti,CITTADINANZA,3230,1403,4633
12,2021,Residenti,CONTESTUALE,35876,30913,66789
12,2021,Residenti,CONTRATTO CONVIVENZA,7,6,13
12,2021,Residenti,ESISTENZA IN VITA,2617,2025,4642
12,2021,Residenti,MATRIMONIO,8808,9431,18239
12,2021,Residenti,NASCITA,12043,11051,23094
12,2021,Residenti,RESIDENZA,31705,35683,67388
12,2021,Residenti,RESIDENZA IN CONVIVENZA,37,30,67
12,2021,Residenti,STATO CIVILE,8768,7208,15976
12,2021,Residenti,STATO FAMIGLIA,29064,33591,62655
12,2021,Residenti,STATO FAMIGLIA CON RAPPORTI PARENTELA,7597,7140,14737
12,2021,Residenti,STATO FAMIGLIA E STATO CIVILE,7127,6231,13358
12,2021,Residenti,STATO LIBERO,5044,3008,8052
12,2021,Residenti,UNIONE CIVILE ,37,39,76
1,2022,AIRE,CITTADINANZA,150,88,238
1,2022,AIRE,CONTESTUALE,375,316,691
1,2022,AIRE,ESISTENZA IN VITA,0,1,1
1,2022,AIRE,MATRIMONIO,112,132,244
1,2022,AIRE,NASCITA,319,279,598
1,2022,AIRE,RESIDENZA,316,336,652
1,2022,AIRE,STATO CIVILE,6,6,12
1,2022,AIRE,STATO FAMIGLIA,188,214,402
1,2022,AIRE,STATO FAMIGLIA CON RAPPORTI PARENTELA,2,2,4
1,2022,AIRE,STATO FAMIGLIA E STATO CIVILE,1,1,2
1,2022,AIRE,STATO LIBERO,5,2,7
1,2022,AIRE,UNIONE CIVILE ,1,2,3
1,2022,Residenti,CITTADINANZA,1749,1567,3316
1,2022,Residenti,CONTESTUALE,39598,39448,79046
1,2022,Residenti,CONTRATTO CONVIVENZA,19,9,28
1,2022,Residenti,ESISTENZA IN VITA,1682,2247,3929
1,2022,Residenti,MATRIMONIO,8089,10956,19045
1,2022,Residenti,NASCITA,11235,12614,23849
1,2022,Residenti,RESIDENZA,36062,47640,83702
1,2022,Residenti,RESIDENZA IN CONVIVENZA,46,41,87
1,2022,Residenti,STATO CIVILE,8081,8847,16928
1,2022,Residenti,STATO FAMIGLIA,47646,61274,108920
1,2022,Residenti,STATO FAMIGLIA CON RAPPORTI PARENTELA,8205,10511,18716
1,2022,Residenti,STATO FAMIGLIA E STATO CIVILE,7433,8970,16403
1,2022,Residenti,STATO LIBERO,5083,3633,8716
1,2022,Residenti,UNIONE CIVILE ,35,40,75
2,2022,AIRE,CITTADINANZA,102,76,178
2,2022,AIRE,CONTESTUALE,330,330,660
2,2022,AIRE,ESISTENZA IN VITA,1,1,2
2,2022,AIRE,MATRIMONIO,105,135,240
2,2022,AIRE,NASCITA,302,249,551
2,2022,AIRE,RESIDENZA,319,339,658
2,2022,AIRE,STATO CIVILE,1,7,8
2,2022,AIRE,STATO FAMIGLIA,187,189,376
2,2022,AIRE,STATO FAMIGLIA CON RAPPORTI PARENTELA,0,5,5
2,2022,AIRE,STATO FAMIGLIA E STATO CIVILE,2,3,5
2,2022,AIRE,STATO LIBERO,0,1,1
2,2022,AIRE,UNIONE CIVILE ,4,2,6
2,2022,Residenti,CITTADINANZA,1772,1443,3215
2,2022,Residenti,CONTESTUALE,41698,40155,81853
2,2022,Residenti,CONTRATTO CONVIVENZA,11,9,20
2,2022,Residenti,ESISTENZA IN VITA,1326,1683,3009
2,2022,Residenti,MATRIMONIO,8488,11214,19702
2,2022,Residenti,NASCITA,10203,11625,21828
2,2022,Residenti,RESIDENZA,32810,42291,75101
2,2022,Residenti,RESIDENZA IN CONVIVENZA,45,41,86
2,2022,Residenti,STATO CIVILE,8718,9664,18382
2,2022,Residenti,STATO FAMIGLIA,37446,48934,86380
2,2022,Residenti,STATO FAMIGLIA CON RAPPORTI PARENTELA,6520,8468,14988
2,2022,Residenti,STATO FAMIGLIA E STATO CIVILE,6632,7885,14517
2,2022,Residenti,STATO LIBERO,5879,4486,10365
2,2022,Residenti,UNIONE CIVILE ,42,39,81
3,2022,AIRE,CITTADINANZA,98,84,182
3,2022,AIRE,CONTESTUALE,345,329,674
3,2022,AIRE,ESISTENZA IN VITA,0,1,1
3,2022,AIRE,MATRIMONIO,99,127,226
3,2022,AIRE,NASCITA,291,288,579
3,2022,AIRE,RESIDENZA,267,336,603
3,2022,AIRE,STATO CIVILE,7,13,20
3,2022,AIRE,STATO FAMIGLIA,185,205,390
3,2022,AIRE,STATO FAMIGLIA CON RAPPORTI PARENTELA,5,0,5
3,2022,AIRE,STATO FAMIGLIA E STATO CIVILE,5,4,9
3,2022,AIRE,STATO LIBERO,4,4,8
3,2022,AIRE,UNIONE CIVILE ,7,1,8
3,2022,Residenti,CITTADINANZA,2088,1406,3494
3,2022,Residenti,CONTESTUALE,46120,42857,88977
3,2022,Residenti,CONTRATTO CONVIVENZA,7,9,16
3,2022,Residenti,ESISTENZA IN VITA,1397,1510,2907
3,2022,Residenti,MATRIMONIO,9400,12222,21622
3,2022,Residenti,NASCITA,11123,12294,23417
3,2022,Residenti,RESIDENZA,37405,46486,83891
3,2022,Residenti,RESIDENZA IN CONVIVENZA,57,44,101
3,2022,Residenti,STATO CIVILE,9846,10097,19943
3,2022,Residenti,STATO FAMIGLIA,36233,46069,82302
3,2022,Residenti,STATO FAMIGLIA CON RAPPORTI PARENTELA,6493,8222,14715
3,2022,Residenti,STATO FAMIGLIA E STATO CIVILE,6732,7667,14399
3,2022,Residenti,STATO LIBERO,6607,5063,11670
3,2022,Residenti,UNIONE CIVILE ,40,48,88
4,2022,AIRE,CITTADINANZA,96,87,183
4,2022,AIRE,CONTESTUALE,346,283,629
4,2022,AIRE,ESISTENZA IN VITA,1,1,2
4,2022,AIRE,MATRIMONIO,71,120,191
4,2022,AIRE,NASCITA,273,228,501
4,2022,AIRE,RESIDENZA,341,448,789
4,2022,AIRE,STATO CIVILE,4,4,8
4,2022,AIRE,STATO FAMIGLIA,160,204,364
4,2022,AIRE,STATO FAMIGLIA CON RAPPORTI PARENTELA,0,6,6
4,2022,AIRE,STATO FAMIGLIA E STATO CIVILE,3,2,5
4,2022,AIRE,STATO LIBERO,1,4,5
4,2022,AIRE,UNIONE CIVILE ,0,2,2
4,2022,Residenti,CITTADINANZA,1641,1204,2845
4,2022,Residenti,CONTESTUALE,36750,34729,71479
4,2022,Residenti,CONTRATTO CONVIVENZA,9,4,13
4,2022,Residenti,ESISTENZA IN VITA,1051,1285,2336
4,2022,Residenti,MATRIMONIO,7539,9512,17051
4,2022,Residenti,NASCITA,9162,9975,19137
4,2022,Residenti,RESIDENZA,32066,39928,71994
4,2022,Residenti,RESIDENZA IN CONVIVENZA,47,45,92
4,2022,Residenti,STATO CIVILE,7781,8351,16132
4,2022,Residenti,STATO FAMIGLIA,27802,34675,62477
4,2022,Residenti,STATO FAMIGLIA CON RAPPORTI PARENTELA,5304,6369,11673
4,2022,Residenti,STATO FAMIGLIA E STATO CIVILE,5329,5972,11301
4,2022,Residenti,STATO LIBERO,5492,4270,9762
4,2022,Residenti,UNIONE CIVILE ,51,36,87
5,2022,AIRE,CITTADINANZA,112,86,198
5,2022,AIRE,CONTESTUALE,395,321,716
5,2022,AIRE,MATRIMONIO,116,138,254
5,2022,AIRE,NASCITA,334,245,579
5,2022,AIRE,RESIDENZA,358,416,774
5,2022,AIRE,STATO CIVILE,8,10,18
5,2022,AIRE,STATO FAMIGLIA,188,189,377
5,2022,AIRE,STATO FAMIGLIA CON RAPPORTI PARENTELA,1,5,6
5,2022,AIRE,STATO FAMIGLIA E STATO CIVILE,3,2,5
5,2022,AIRE,STATO LIBERO,4,3,7
5,2022,AIRE,UNIONE CIVILE ,0,1,1
5,2022,Residenti,CITTADINANZA,1764,1367,3131
5,2022,Residenti,CONTESTUALE,40289,38772,79061
5,2022,Residenti,CONTRATTO CONVIVENZA,19,7,26
5,2022,Residenti,ESISTENZA IN VITA,1171,1377,2548
5,2022,Residenti,MATRIMONIO,8369,11039,19408
5,2022,Residenti,NASCITA,9857,11378,21235
5,2022,Residenti,RESIDENZA,38614,46692,85306
5,2022,Residenti,RESIDENZA IN CONVIVENZA,43,52,95
5,2022,Residenti,STATO CIVILE,9324,9930,19254
5,2022,Residenti,STATO FAMIGLIA,33271,41455,74726
5,2022,Residenti,STATO FAMIGLIA CON RAPPORTI PARENTELA,5997,7389,13386
5,2022,Residenti,STATO FAMIGLIA E STATO CIVILE,6023,6937,12960
5,2022,Residenti,STATO LIBERO,6297,4991,11288
5,2022,Residenti,UNIONE CIVILE ,38,33,71
6,2022,AIRE,CITTADINANZA,123,82,205
6,2022,AIRE,CONTESTUALE,321,257,578
6,2022,AIRE,MATRIMONIO,85,101,186
6,2022,AIRE,NASCITA,285,226,511
6,2022,AIRE,RESIDENZA,291,380,671
6,2022,AIRE,STATO CIVILE,6,6,12
6,2022,AIRE,STATO FAMIGLIA,176,209,385
6,2022,AIRE,STATO FAMIGLIA CON RAPPORTI PARENTELA,2,5,7
6,2022,AIRE,STATO FAMIGLIA E STATO CIVILE,2,1,3
6,2022,AIRE,STATO LIBERO,4,2,6
6,2022,AIRE,UNIONE CIVILE ,1,0,1
6,2022,Residenti,CITTADINANZA,1799,1390,3189
6,2022,Residenti,CONTESTUALE,36989,37034,74023
6,2022,Residenti,CONTRATTO CONVIVENZA,17,6,23
6,2022,Residenti,ESISTENZA IN VITA,1081,1377,2458
6,2022,Residenti,MATRIMONIO,8433,10567,19000
6,2022,Residenti,NASCITA,9161,10058,19219
6,2022,Residenti,RESIDENZA,35263,43641,78904
6,2022,Residenti,RESIDENZA IN CONVIVENZA,39,44,83
6,2022,Residenti,STATO CIVILE,8928,9558,18486
6,2022,Residenti,STATO FAMIGLIA,30459,38085,68544
6,2022,Residenti,STATO FAMIGLIA CON RAPPORTI PARENTELA,5609,6727,12336
6,2022,Residenti,STATO FAMIGLIA E STATO CIVILE,5335,6399,11734
6,2022,Residenti,STATO LIBERO,5701,4750,10451
6,2022,Residenti,UNIONE CIVILE ,41,40,81
7,2022,AIRE,CITTADINANZA,94,76,170
7,2022,AIRE,CONTESTUALE,300,261,561
7,2022,AIRE,ESISTENZA IN VITA,2,0,2
7,2022,AIRE,MATRIMONIO,109,121,230
7,2022,AIRE,NASCITA,264,223,487
7,2022,AIRE,RESIDENZA,320,366,686
7,2022,AIRE,STATO CIVILE,6,6,12
7,2022,AIRE,STATO FAMIGLIA,182,188,370
7,2022,AIRE,STATO FAMIGLIA CON RAPPORTI PARENTELA,1,1,2
7,2022,AIRE,STATO FAMIGLIA E STATO CIVILE,1,2,3
7,2022,AIRE,STATO LIBERO,1,0,1
7,2022,AIRE,UNIONE CIVILE ,2,0,2
7,2022,Residenti,CITTADINANZA,1550,1188,2738
7,2022,Residenti,CONTESTUALE,32020,44447,76467
7,2022,Residenti,CONTRATTO CONVIVENZA,15,16,31
7,2022,Residenti,ESISTENZA IN VITA,1043,1299,2342
7,2022,Residenti,MATRIMONIO,8067,9857,17924
7,2022,Residenti,NASCITA,8594,9660,18254
7,2022,Residenti,RESIDENZA,32593,40602,73195
7,2022,Residenti,RESIDENZA IN CONVIVENZA,40,29,69
7,2022,Residenti,STATO CIVILE,7907,8471,16378
7,2022,Residenti,STATO FAMIGLIA,27245,36989,64234
7,2022,Residenti,STATO FAMIGLIA CON RAPPORTI PARENTELA,5205,6560,11765
7,2022,Residenti,STATO FAMIGLIA E STATO CIVILE,4968,5554,10522
7,2022,Residenti,STATO LIBERO,4877,4122,8999
7,2022,Residenti,UNIONE CIVILE ,52,50,102
8,2022,AIRE,CITTADINANZA,104,69,173
8,2022,AIRE,CONTESTUALE,332,271,603
8,2022,AIRE,ESISTENZA IN VITA,2,0,2
8,2022,AIRE,MATRIMONIO,87,87,174
8,2022,AIRE,NASCITA,339,271,610
8,2022,AIRE,RESIDENZA,315,364,679
8,2022,AIRE,STATO CIVILE,5,1,6
8,2022,AIRE,STATO FAMIGLIA,175,179,354
8,2022,AIRE,STATO FAMIGLIA CON RAPPORTI PARENTELA,7,4,11
8,2022,AIRE,STATO FAMIGLIA E STATO CIVILE,1,1,2
8,2022,AIRE,STATO LIBERO,2,0,2
8,2022,AIRE,UNIONE CIVILE ,0,3,3
8,2022,Residenti,CITTADINANZA,1382,1024,2406
8,2022,Residenti,CONTESTUALE,24097,35090,59187
8,2022,Residenti,CONTRATTO CONVIVENZA,13,11,24
8,2022,Residenti,ESISTENZA IN VITA,799,964,1763
8,2022,Residenti,ISCRIZIONE NELLE LISTE ELETTORALI,0,1,1
8,2022,Residenti,MATRIMONIO,5390,5998,11388
8,2022,Residenti,NASCITA,7909,8476,16385
8,2022,Residenti,RESIDENZA,27608,33921,61529
8,2022,Residenti,RESIDENZA IN CONVIVENZA,25,40,65
8,2022,Residenti,STATO CIVILE,4638,5120,9758
8,2022,Residenti,STATO FAMIGLIA,21752,29623,51375
8,2022,Residenti,STATO FAMIGLIA CON RAPPORTI PARENTELA,4244,5404,9648
8,2022,Residenti,STATO FAMIGLIA E STATO CIVILE,3429,4096,7525
8,2022,Residenti,STATO LIBERO,2329,1885,4214
8,2022,Residenti,UNIONE CIVILE ,32,35,67
9,2022,AIRE,CITTADINANZA,127,62,189
9,2022,AIRE,CONTESTUALE,330,290,620
9,2022,AIRE,ESISTENZA IN VITA,3,4,7
9,2022,AIRE,MATRIMONIO,118,123,241
9,2022,AIRE,NASCITA,302,276,578
9,2022,AIRE,RESIDENZA,297,403,700
9,2022,AIRE,STATO CIVILE,11,5,16
9,2022,AIRE,STATO FAMIGLIA,187,197,384
9,2022,AIRE,STATO FAMIGLIA CON RAPPORTI PARENTELA,7,3,10
9,2022,AIRE,STATO FAMIGLIA E STATO CIVILE,3,0,3
9,2022,AIRE,STATO LIBERO,5,4,9
9,2022,Residenti,CITTADINANZA,2251,1877,4128
9,2022,Residenti,CONTESTUALE,42850,85873,128723
9,2022,Residenti,CONTRATTO CONVIVENZA,11,21,32
9,2022,Residenti,ESISTENZA IN VITA,1358,1398,2756
9,2022,Residenti,MATRIMONIO,9566,12018,21584
9,2022,Residenti,NASCITA,11005,14305,25310
9,2022,Residenti,RESIDENZA,40641,53477,94118
9,2022,Residenti,RESIDENZA IN CONVIVENZA,53,59,112
9,2022,Residenti,STATO CIVILE,9356,10148,19504
9,2022,Residenti,STATO FAMIGLIA,35178,55512,90690
9,2022,Residenti,STATO FAMIGLIA CON RAPPORTI PARENTELA,6480,8542,15022
9,2022,Residenti,STATO FAMIGLIA E STATO CIVILE,5688,6985,12673
9,2022,Residenti,STATO LIBERO,5630,4880,10510
9,2022,Residenti,UNIONE CIVILE ,46,62,108
10,2022,AIRE,CITTADINANZA,126,73,199
10,2022,AIRE,CONTESTUALE,346,317,663
10,2022,AIRE,ESISTENZA IN VITA,1,0,1
10,2022,AIRE,MATRIMONIO,112,114,226
10,2022,AIRE,NASCITA,341,269,610
10,2022,AIRE,RESIDENZA,353,388,741
10,2022,AIRE,STATO CIVILE,13,6,19
10,2022,AIRE,STATO FAMIGLIA,197,208,405
10,2022,AIRE,STATO FAMIGLIA CON RAPPORTI PARENTELA,7,5,12
10,2022,AIRE,STATO FAMIGLIA E STATO CIVILE,5,3,8
10,2022,AIRE,STATO LIBERO,6,5,11
10,2022,Residenti,CITTADINANZA,2082,1751,3833
10,2022,Residenti,CONTESTUALE,42129,68132,110261
10,2022,Residenti,CONTRATTO CONVIVENZA,14,17,31
10,2022,Residenti,ESISTENZA IN VITA,1289,1428,2717
10,2022,Residenti,GODIMENTO DEI DIRITTI POLITICI,0,1,1
10,2022,Residenti,ISCRIZIONE NELLE LISTE ELETTORALI,0,1,1
10,2022,Residenti,MATRIMONIO,9493,11654,21147
10,2022,Residenti,NASCITA,10285,12912,23197
10,2022,Residenti,RESIDENZA,40371,52474,92845
10,2022,Residenti,RESIDENZA IN CONVIVENZA,50,50,100
10,2022,Residenti,STATO CIVILE,9052,9905,18957
10,2022,Residenti,STATO FAMIGLIA,35797,50442,86239
10,2022,Residenti,STATO FAMIGLIA CON RAPPORTI PARENTELA,6609,8442,15051
10,2022,Residenti,STATO FAMIGLIA E STATO CIVILE,6136,7374,13510
10,2022,Residenti,STATO LIBERO,5075,4548,9623
10,2022,Residenti,UNIONE CIVILE ,54,48,102
11,2022,AIRE,CITTADINANZA,145,66,211
11,2022,AIRE,CONTESTUALE,381,336,717
11,2022,AIRE,ESISTENZA IN VITA,2,1,3
11,2022,AIRE,MATRIMONIO,118,123,241
11,2022,AIRE,NASCITA,354,270,624
11,2022,AIRE,RESIDENZA,349,344,693
11,2022,AIRE,STATO CIVILE,9,3,12
11,2022,AIRE,STATO FAMIGLIA,204,197,401
11,2022,AIRE,STATO FAMIGLIA CON RAPPORTI PARENTELA,3,2,5
11,2022,AIRE,STATO FAMIGLIA E STATO CIVILE,4,6,10
11,2022,AIRE,STATO LIBERO,1,2,3
11,2022,AIRE,UNIONE CIVILE ,0,1,1
11,2022,Residenti,CITTADINANZA,2261,1693,3954
11,2022,Residenti,CONTESTUALE,40164,50192,90356
11,2022,Residenti,CONTRATTO CONVIVENZA,17,8,25
11,2022,Residenti,ESISTENZA IN VITA,1410,1599,3009
11,2022,Residenti,GODIMENTO DEI DIRITTI POLITICI,0,3,3
11,2022,Residenti,ISCRIZIONE NELLE LISTE ELETTORALI,0,1,1
11,2022,Residenti,MATRIMONIO,8827,11598,20425
11,2022,Residenti,NASCITA,10369,11898,22267
11,2022,Residenti,RESIDENZA,39667,48757,88424
11,2022,Residenti,RESIDENZA IN CONVIVENZA,50,48,98
11,2022,Residenti,STATO CIVILE,9669,10228,19897
11,2022,Residenti,STATO FAMIGLIA,33630,45378,79008
11,2022,Residenti,STATO FAMIGLIA CON RAPPORTI PARENTELA,6880,8580,15460
11,2022,Residenti,STATO FAMIGLIA E STATO CIVILE,5979,6981,12960
11,2022,Residenti,STATO LIBERO,5501,4994,10495
11,2022,Residenti,UNIONE CIVILE ,62,37,99
12,2022,AIRE,CITTADINANZA,173,59,232
12,2022,AIRE,CONTESTUALE,437,311,748
12,2022,AIRE,ESISTENZA IN VITA,1,1,2
12,2022,AIRE,MATRIMONIO,111,113,224
12,2022,AIRE,NASCITA,330,245,575
12,2022,AIRE,RESIDENZA,448,368,816
12,2022,AIRE,STATO CIVILE,8,6,14
12,2022,AIRE,STATO FAMIGLIA,241,187,428
12,2022,AIRE,STATO FAMIGLIA CON RAPPORTI PARENTELA,4,3,7
12,2022,AIRE,STATO FAMIGLIA E STATO CIVILE,2,2,4
12,2022,AIRE,STATO LIBERO,2,1,3
12,2022,AIRE,UNIONE CIVILE ,1,0,1
12,2022,Residenti,CITTADINANZA,2673,1381,4054
12,2022,Residenti,CONTESTUALE,34647,34605,69252
12,2022,Residenti,CONTRATTO CONVIVENZA,18,9,27
12,2022,Residenti,ESISTENZA IN VITA,1955,1538,3493
12,2022,Residenti,MATRIMONIO,7291,8389,15680
12,2022,Residenti,NASCITA,9739,9085,18824
12,2022,Residenti,RESIDENZA,35136,40067,75203
12,2022,Residenti,RESIDENZA IN CONVIVENZA,44,52,96
12,2022,Residenti,STATO CIVILE,8357,7921,16278
12,2022,Residenti,STATO FAMIGLIA,29678,35121,64799
12,2022,Residenti,STATO FAMIGLIA CON RAPPORTI PARENTELA,6632,6776,13408
12,2022,Residenti,STATO FAMIGLIA E STATO CIVILE,5835,5354,11189
12,2022,Residenti,STATO LIBERO,4852,3379,8231
12,2022,Residenti,UNIONE CIVILE ,42,35,77
1,2023,AIRE,CITTADINANZA,13,187,200
1,2023,AIRE,CONTESTUALE,38,823,861
1,2023,AIRE,ESISTENZA IN VITA,0,4,4
1,2023,AIRE,MATRIMONIO,14,221,235
1,2023,AIRE,NASCITA,29,573,602
1,2023,AIRE,RESIDENZA,35,899,934
1,2023,AIRE,STATO CIVILE,2,21,23
1,2023,AIRE,STATO FAMIGLIA,23,415,438
1,2023,AIRE,STATO FAMIGLIA CON RAPPORTI PARENTELA,0,11,11
1,2023,AIRE,STATO FAMIGLIA E STATO CIVILE,0,6,6
1,2023,AIRE,STATO LIBERO,1,10,11
1,2023,AIRE,UNIONE CIVILE ,0,2,2
1,2023,Residenti,CITTADINANZA,136,3170,3306
1,2023,Residenti,CONTESTUALE,2291,90116,92407
1,2023,Residenti,CONTRATTO CONVIVENZA,0,26,26
1,2023,Residenti,ESISTENZA IN VITA,105,2998,3103
1,2023,Residenti,MATRIMONIO,408,17714,18122
1,2023,Residenti,NASCITA,711,22003,22714
1,2023,Residenti,RESIDENZA,2469,93845,96314
1,2023,Residenti,RESIDENZA IN CONVIVENZA,4,116,120
1,2023,Residenti,STATO CIVILE,439,17622,18061
1,2023,Residenti,STATO FAMIGLIA,3223,117453,120676
1,2023,Residenti,STATO FAMIGLIA CON RAPPORTI PARENTELA,463,18718,19181
1,2023,Residenti,STATO FAMIGLIA E STATO CIVILE,454,15321,15775
1,2023,Residenti,STATO LIBERO,212,7724,7936
1,2023,Residenti,UNIONE CIVILE ,2,76,78
2,2023,AIRE,CITTADINANZA,0,183,183
2,2023,AIRE,CONTESTUALE,0,735,735
2,2023,AIRE,ESISTENZA IN VITA,0,2,2
2,2023,AIRE,MATRIMONIO,0,232,232
2,2023,AIRE,NASCITA,0,597,597
2,2023,AIRE,RESIDENZA,0,756,756
2,2023,AIRE,STATO CIVILE,0,21,21
2,2023,AIRE,STATO FAMIGLIA,0,410,410
2,2023,AIRE,STATO FAMIGLIA CON RAPPORTI PARENTELA,0,11,11
2,2023,AIRE,STATO FAMIGLIA E STATO CIVILE,0,11,11
2,2023,AIRE,STATO LIBERO,0,11,11
2,2023,AIRE,UNIONE CIVILE ,0,6,6
2,2023,Residenti,CITTADINANZA,0,2963,2963
2,2023,Residenti,CONTESTUALE,0,86237,86237
2,2023,Residenti,CONTRATTO CONVIVENZA,0,18,18
2,2023,Residenti,ESISTENZA IN VITA,0,2287,2287
2,2023,Residenti,MATRIMONIO,0,18138,18138
2,2023,Residenti,NASCITA,0,19863,19863
2,2023,Residenti,RESIDENZA,0,87939,87939
2,2023,Residenti,RESIDENZA IN CONVIVENZA,0,106,106
2,2023,Residenti,STATO CIVILE,0,17810,17810
2,2023,Residenti,STATO FAMIGLIA,0,88407,88407
2,2023,Residenti,STATO FAMIGLIA CON RAPPORTI PARENTELA,0,14600,14600
2,2023,Residenti,STATO FAMIGLIA E STATO CIVILE,0,12998,12998
2,2023,Residenti,STATO LIBERO,0,8335,8335
2,2023,Residenti,UNIONE CIVILE ,0,79,79
3,2023,AIRE,CITTADINANZA,0,185,185
3,2023,AIRE,CONTESTUALE,0,764,764
3,2023,AIRE,ESISTENZA IN VITA,0,6,6
3,2023,AIRE,MATRIMONIO,0,284,284
3,2023,AIRE,NASCITA,0,562,562
3,2023,AIRE,RESIDENZA,0,899,899
3,2023,AIRE,STATO CIVILE,0,21,21
3,2023,AIRE,STATO FAMIGLIA,0,391,391
3,2023,AIRE,STATO FAMIGLIA CON RAPPORTI PARENTELA,0,15,15
3,2023,AIRE,STATO FAMIGLIA E STATO CIVILE,0,8,8
3,2023,AIRE,STATO LIBERO,0,8,8
3,2023,AIRE,UNIONE CIVILE ,0,2,2
3,2023,Residenti,CITTADINANZA,0,2958,2958
3,2023,Residenti,CONTESTUALE,0,85753,85753
3,2023,Residenti,CONTRATTO CONVIVENZA,0,23,23
3,2023,Residenti,ESISTENZA IN VITA,0,2345,2345
3,2023,Residenti,MATRIMONIO,0,17006,17006
3,2023,Residenti,NASCITA,0,19907,19907
3,2023,Residenti,RESIDENZA,0,88587,88587
3,2023,Residenti,RESIDENZA IN CONVIVENZA,0,101,101
3,2023,Residenti,STATO CIVILE,0,17279,17279
3,2023,Residenti,STATO FAMIGLIA,0,77989,77989
3,2023,Residenti,STATO FAMIGLIA CON RAPPORTI PARENTELA,0,13178,13178
3,2023,Residenti,STATO FAMIGLIA E STATO CIVILE,0,11767,11767
3,2023,Residenti,STATO LIBERO,0,7664,7664
3,2023,Residenti,UNIONE CIVILE ,0,81,81
4,2023,AIRE,CITTADINANZA,0,158,158
4,2023,AIRE,CONTESTUALE,0,623,623
4,2023,AIRE,ESISTENZA IN VITA,0,4,4
4,2023,AIRE,MATRIMONIO,0,190,190
4,2023,AIRE,NASCITA,0,445,445
4,2023,AIRE,RESIDENZA,0,702,702
4,2023,AIRE,STATO CIVILE,0,15,15
4,2023,AIRE,STATO FAMIGLIA,0,328,328
4,2023,AIRE,STATO FAMIGLIA CON RAPPORTI PARENTELA,0,5,5
4,2023,AIRE,STATO FAMIGLIA E STATO CIVILE,0,5,5
4,2023,AIRE,STATO LIBERO,0,7,7
4,2023,AIRE,UNIONE CIVILE ,0,3,3
4,2023,Residenti,CITTADINANZA,0,2345,2345
4,2023,Residenti,CONTESTUALE,0,63613,63613
4,2023,Residenti,CONTRATTO CONVIVENZA,0,13,13
4,2023,Residenti,ESISTENZA IN VITA,0,1629,1629
4,2023,Residenti,MATRIMONIO,0,11892,11892
4,2023,Residenti,NASCITA,0,14547,14547
4,2023,Residenti,RESIDENZA,0,69083,69083
4,2023,Residenti,RESIDENZA IN CONVIVENZA,0,88,88
4,2023,Residenti,STATO CIVILE,0,12485,12485
4,2023,Residenti,STATO FAMIGLIA,0,54532,54532
4,2023,Residenti,STATO FAMIGLIA CON RAPPORTI PARENTELA,0,9424,9424
4,2023,Residenti,STATO FAMIGLIA E STATO CIVILE,0,8593,8593
4,2023,Residenti,STATO LIBERO,0,5508,5508
4,2023,Residenti,UNIONE CIVILE ,0,63,63
5,2023,AIRE,CITTADINANZA,0,139,139
5,2023,AIRE,CONTESTUALE,0,619,619
5,2023,AIRE,ESISTENZA IN VITA,0,4,4
5,2023,AIRE,MATRIMONIO,0,238,238
5,2023,AIRE,NASCITA,0,449,449
5,2023,AIRE,RESIDENZA,0,791,791
5,2023,AIRE,STATO CIVILE,0,16,16
5,2023,AIRE,STATO FAMIGLIA,0,381,381
5,2023,AIRE,STATO FAMIGLIA CON RAPPORTI PARENTELA,0,8,8
5,2023,AIRE,STATO FAMIGLIA E STATO CIVILE,0,11,11
5,2023,AIRE,STATO LIBERO,0,8,8
5,2023,AIRE,UNIONE CIVILE ,0,4,4
5,2023,Residenti,CITTADINANZA,0,2759,2759
5,2023,Residenti,CONTESTUALE,0,78322,78322
5,2023,Residenti,CONTRATTO CONVIVENZA,0,14,14
5,2023,Residenti,ESISTENZA IN VITA,0,1960,1960
5,2023,Residenti,MATRIMONIO,0,16016,16016
5,2023,Residenti,NASCITA,0,17406,17406
5,2023,Residenti,RESIDENZA,0,84746,84746
5,2023,Residenti,RESIDENZA IN CONVIVENZA,0,118,118
5,2023,Residenti,STATO CIVILE,0,15945,15945
5,2023,Residenti,STATO FAMIGLIA,0,66019,66019
5,2023,Residenti,STATO FAMIGLIA CON RAPPORTI PARENTELA,0,11091,11091
5,2023,Residenti,STATO FAMIGLIA E STATO CIVILE,0,10380,10380
5,2023,Residenti,STATO LIBERO,0,6477,6477
5,2023,Residenti,UNIONE CIVILE ,0,95,95
6,2023,AIRE,CITTADINANZA,0,121,121
6,2023,AIRE,CONTESTUALE,0,591,591
6,2023,AIRE,ESISTENZA IN VITA,0,3,3
6,2023,AIRE,MATRIMONIO,0,182,182
6,2023,AIRE,NASCITA,0,466,466
6,2023,AIRE,RESIDENZA,0,759,759
6,2023,AIRE,STATO CIVILE,0,13,13
6,2023,AIRE,STATO FAMIGLIA,0,312,312
6,2023,AIRE,STATO FAMIGLIA CON RAPPORTI PARENTELA,0,4,4
6,2023,AIRE,STATO FAMIGLIA E STATO CIVILE,0,3,3
6,2023,AIRE,STATO LIBERO,0,6,6
6,2023,Residenti,CITTADINANZA,0,2485,2485
6,2023,Residenti,CONTESTUALE,0,67657,67657
6,2023,Residenti,CONTRATTO CONVIVENZA,0,11,11
6,2023,Residenti,ESISTENZA IN VITA,0,2083,2083
6,2023,Residenti,MATRIMONIO,0,14685,14685
6,2023,Residenti,NASCITA,0,15887,15887
6,2023,Residenti,RESIDENZA,0,75585,75585
6,2023,Residenti,RESIDENZA IN CONVIVENZA,0,85,85
6,2023,Residenti,STATO CIVILE,0,13713,13713
6,2023,Residenti,STATO FAMIGLIA,0,59990,59990
6,2023,Residenti,STATO FAMIGLIA CON RAPPORTI PARENTELA,0,10310,10310
6,2023,Residenti,STATO FAMIGLIA E STATO CIVILE,0,9035,9035
6,2023,Residenti,STATO LIBERO,0,5755,5755
6,2023,Residenti,UNIONE CIVILE ,0,70,70
7,2023,AIRE,CITTADINANZA,0,150,150
7,2023,AIRE,CONTESTUALE,0,608,608
7,2023,AIRE,ESISTENZA IN VITA,0,3,3
7,2023,AIRE,MATRIMONIO,0,198,198
7,2023,AIRE,NASCITA,0,481,481
7,2023,AIRE,RESIDENZA,0,651,651
7,2023,AIRE,STATO CIVILE,0,15,15
7,2023,AIRE,STATO FAMIGLIA,0,306,306
7,2023,AIRE,STATO FAMIGLIA CON RAPPORTI PARENTELA,0,6,6
7,2023,AIRE,STATO FAMIGLIA E STATO CIVILE,0,4,4
7,2023,AIRE,STATO LIBERO,0,7,7
7,2023,AIRE,UNIONE CIVILE ,0,6,6
7,2023,Residenti,CITTADINANZA,0,2205,2205
7,2023,Residenti,CONTESTUALE,0,83834,83834
7,2023,Residenti,CONTRATTO CONVIVENZA,0,16,16
7,2023,Residenti,ESISTENZA IN VITA,0,1835,1835
7,2023,Residenti,MATRIMONIO,0,14338,14338
7,2023,Residenti,NASCITA,0,16022,16022
7,2023,Residenti,RESIDENZA,0,73468,73468
7,2023,Residenti,RESIDENZA IN CONVIVENZA,0,90,90
7,2023,Residenti,STATO CIVILE,0,12773,12773
7,2023,Residenti,STATO FAMIGLIA,0,64349,64349
7,2023,Residenti,STATO FAMIGLIA CON RAPPORTI PARENTELA,0,10552,10552
7,2023,Residenti,STATO FAMIGLIA E STATO CIVILE,0,8315,8315
7,2023,Residenti,STATO LIBERO,0,5156,5156
7,2023,Residenti,UNIONE CIVILE ,0,97,97
8,2023,AIRE,CITTADINANZA,9,86,95
8,2023,AIRE,CONTESTUALE,61,377,438
8,2023,AIRE,MATRIMONIO,23,140,163
8,2023,AIRE,NASCITA,98,331,429
8,2023,AIRE,RESIDENZA,100,473,573
8,2023,AIRE,STATO CIVILE,2,11,13
8,2023,AIRE,STATO FAMIGLIA,22,206,228
8,2023,AIRE,STATO FAMIGLIA CON RAPPORTI PARENTELA,1,2,3
8,2023,AIRE,STATO FAMIGLIA E STATO CIVILE,0,1,1
8,2023,AIRE,STATO LIBERO,2,1,3
8,2023,AIRE,UNIONE CIVILE ,1,1,2
8,2023,Residenti,CITTADINANZA,69,1774,1843
8,2023,Residenti,CONTESTUALE,5211,61042,66253
8,2023,Residenti,CONTRATTO CONVIVENZA,3,13,16
8,2023,Residenti,ESISTENZA IN VITA,90,1037,1127
8,2023,Residenti,MATRIMONIO,744,7646,8390
8,2023,Residenti,NASCITA,1163,11387,12550
8,2023,Residenti,RESIDENZA,3281,52759,56040
8,2023,Residenti,RESIDENZA IN CONVIVENZA,1,57,58
8,2023,Residenti,STATO CIVILE,692,6592,7284
8,2023,Residenti,STATO FAMIGLIA,3374,43462,46836
8,2023,Residenti,STATO FAMIGLIA CON RAPPORTI PARENTELA,503,7212,7715
8,2023,Residenti,STATO FAMIGLIA E STATO CIVILE,417,5582,5999
8,2023,Residenti,STATO LIBERO,768,2115,2883
8,2023,Residenti,UNIONE CIVILE ,10,49,59
9,2023,AIRE,CITTADINANZA,11,104,115
9,2023,AIRE,CONTESTUALE,89,434,523
9,2023,AIRE,ESISTENZA IN VITA,0,1,1
9,2023,AIRE,MATRIMONIO,30,184,214
9,2023,AIRE,NASCITA,134,280,414
9,2023,AIRE,RESIDENZA,123,516,639
9,2023,AIRE,STATO CIVILE,1,8,9
9,2023,AIRE,STATO FAMIGLIA,38,245,283
9,2023,AIRE,STATO FAMIGLIA CON RAPPORTI PARENTELA,0,7,7
9,2023,AIRE,STATO FAMIGLIA E STATO CIVILE,0,8,8
9,2023,AIRE,STATO LIBERO,4,7,11
9,2023,AIRE,UNIONE CIVILE ,1,0,1
9,2023,Residenti,CITTADINANZA,104,2185,2289
9,2023,Residenti,CONTESTUALE,9130,133606,142736
9,2023,Residenti,CONTRATTO CONVIVENZA,1,9,10
9,2023,Residenti,ESISTENZA IN VITA,148,1533,1681
9,2023,Residenti,MATRIMONIO,1601,13137,14738
9,2023,Residenti,NASCITA,1648,17421,19069
9,2023,Residenti,RESIDENZA,5169,73828,78997
9,2023,Residenti,RESIDENZA IN CONVIVENZA,2,76,78
9,2023,Residenti,STATO CIVILE,2008,12172,14180
9,2023,Residenti,STATO FAMIGLIA,5684,73265,78949
9,2023,Residenti,STATO FAMIGLIA CON RAPPORTI PARENTELA,721,10998,11719
9,2023,Residenti,STATO FAMIGLIA E STATO CIVILE,789,9025,9814
9,2023,Residenti,STATO LIBERO,1924,4388,6312
9,2023,Residenti,UNIONE CIVILE ,13,76,89
10,2023,AIRE,CITTADINANZA,6,105,111
10,2023,AIRE,CONTESTUALE,111,470,581
10,2023,AIRE,ESISTENZA IN VITA,0,3,3
10,2023,AIRE,MATRIMONIO,24,184,208
10,2023,AIRE,NASCITA,98,365,463
10,2023,AIRE,RESIDENZA,124,667,791
10,2023,AIRE,STATO CIVILE,2,11,13
10,2023,AIRE,STATO FAMIGLIA,36,256,292
10,2023,AIRE,STATO FAMIGLIA CON RAPPORTI PARENTELA,0,6,6
10,2023,AIRE,STATO FAMIGLIA E STATO CIVILE,0,4,4
10,2023,AIRE,STATO LIBERO,3,2,5
10,2023,AIRE,UNIONE CIVILE ,0,1,1
10,2023,Residenti,CITTADINANZA,127,2352,2479
10,2023,Residenti,CONTESTUALE,10173,103218,113391
10,2023,Residenti,CONTRATTO CONVIVENZA,3,16,19
10,2023,Residenti,ESISTENZA IN VITA,181,1815,1996
10,2023,Residenti,MATRIMONIO,1659,14724,16383
10,2023,Residenti,NASCITA,1522,16875,18397
10,2023,Residenti,RESIDENZA,5589,76229,81818
10,2023,Residenti,RESIDENZA IN CONVIVENZA,5,95,100
10,2023,Residenti,STATO CIVILE,2150,12690,14840
10,2023,Residenti,STATO FAMIGLIA,5661,68738,74399
10,2023,Residenti,STATO FAMIGLIA CON RAPPORTI PARENTELA,774,10952,11726
10,2023,Residenti,STATO FAMIGLIA E STATO CIVILE,905,9517,10422
10,2023,Residenti,STATO LIBERO,2132,4549,6681
10,2023,Residenti,UNIONE CIVILE ,9,73,82
11,2023,AIRE,CITTADINANZA,7,112,119
11,2023,AIRE,CONTESTUALE,102,463,565
11,2023,AIRE,MATRIMONIO,21,172,193
11,2023,AIRE,NASCITA,136,315,451
11,2023,AIRE,RESIDENZA,125,603,728
11,2023,AIRE,STATO CIVILE,3,6,9
11,2023,AIRE,STATO FAMIGLIA,28,245,273
11,2023,AIRE,STATO FAMIGLIA CON RAPPORTI PARENTELA,0,6,6
11,2023,AIRE,STATO FAMIGLIA E STATO CIVILE,1,0,1
11,2023,AIRE,STATO LIBERO,1,4,5
11,2023,Residenti,CITTADINANZA,92,1961,2053
11,2023,Residenti,CONTESTUALE,9612,69647,79259
11,2023,Residenti,CONTRATTO CONVIVENZA,1,10,11
11,2023,Residenti,ESISTENZA IN VITA,177,1817,1994
11,2023,Residenti,MATRIMONIO,1390,13324,14714
11,2023,Residenti,NASCITA,1436,14158,15594
11,2023,Residenti,RESIDENZA,4962,70227,75189
11,2023,Residenti,RESIDENZA IN CONVIVENZA,1,66,67
11,2023,Residenti,STATO CIVILE,2107,11995,14102
11,2023,Residenti,STATO FAMIGLIA,5477,60629,66106
11,2023,Residenti,STATO FAMIGLIA CON RAPPORTI PARENTELA,771,10650,11421
11,2023,Residenti,STATO FAMIGLIA E STATO CIVILE,817,8707,9524
11,2023,Residenti,STATO LIBERO,2406,4896,7302
11,2023,Residenti,UNIONE CIVILE ,21,69,90
12,2023,AIRE,CITTADINANZA,14,91,105
12,2023,AIRE,CONTESTUALE,110,453,563
12,2023,AIRE,ESISTENZA IN VITA,0,2,2
12,2023,AIRE,MATRIMONIO,25,154,179
12,2023,AIRE,NASCITA,106,296,402
12,2023,AIRE,RESIDENZA,88,614,702
12,2023,AIRE,STATO CIVILE,2,9,11
12,2023,AIRE,STATO FAMIGLIA,26,222,248
12,2023,AIRE,STATO FAMIGLIA CON RAPPORTI PARENTELA,0,8,8
12,2023,AIRE,STATO FAMIGLIA E STATO CIVILE,0,4,4
12,2023,AIRE,STATO LIBERO,2,3,5
12,2023,AIRE,UNIONE CIVILE ,1,0,1
12,2023,Residenti,CITTADINANZA,97,1831,1928
12,2023,Residenti,CONTESTUALE,7666,60099,67765
12,2023,Residenti,CONTRATTO CONVIVENZA,2,10,12
12,2023,Residenti,ESISTENZA IN VITA,166,2268,2434
12,2023,Residenti,MATRIMONIO,996,10982,11978
12,2023,Residenti,NASCITA,1242,12127,13369
12,2023,Residenti,RESIDENZA,4304,125681,129985
12,2023,Residenti,RESIDENZA IN CONVIVENZA,1,68,69
12,2023,Residenti,STATO CIVILE,1615,10020,11635
12,2023,Residenti,STATO FAMIGLIA,4538,50134,54672
12,2023,Residenti,STATO FAMIGLIA CON RAPPORTI PARENTELA,715,8128,8843
12,2023,Residenti,STATO FAMIGLIA E STATO CIVILE,647,6560,7207
12,2023,Residenti,STATO LIBERO,1699,3720,5419
12,2023,Residenti,UNIONE CIVILE ,8,52,60
1,2024,AIRE,CITTADINANZA,15,100,115
1,2024,AIRE,CONTESTUALE,123,564,687
1,2024,AIRE,MATRIMONIO,32,183,215
1,2024,AIRE,NASCITA,187,369,556
1,2024,AIRE,RESIDENZA,146,897,1043
1,2024,AIRE,STATO CIVILE,3,10,13
1,2024,AIRE,STATO FAMIGLIA,33,289,322
1,2024,AIRE,STATO FAMIGLIA CON RAPPORTI PARENTELA,1,6,7
1,2024,AIRE,STATO FAMIGLIA E STATO CIVILE,0,3,3
1,2024,AIRE,STATO LIBERO,4,12,16
1,2024,AIRE,UNIONE CIVILE ,0,2,2
1,2024,Residenti,CITTADINANZA,137,2730,2867
1,2024,Residenti,CONTESTUALE,11913,109165,121078
1,2024,Residenti,CONTRATTO CONVIVENZA,1,23,24
1,2024,Residenti,ESISTENZA IN VITA,211,4536,4747
1,2024,Residenti,MATRIMONIO,1366,17050,18416
1,2024,Residenti,NASCITA,1840,19401,21241
1,2024,Residenti,RESIDENZA,6057,245142,251199
1,2024,Residenti,RESIDENZA IN CONVIVENZA,0,172,172
1,2024,Residenti,STATO CIVILE,2071,16078,18149
1,2024,Residenti,STATO FAMIGLIA,7781,110333,118114
1,2024,Residenti,STATO FAMIGLIA CON RAPPORTI PARENTELA,1118,14376,15494
1,2024,Residenti,STATO FAMIGLIA E STATO CIVILE,1009,11884,12893
1,2024,Residenti,STATO LIBERO,2250,5132,7382
1,2024,Residenti,UNIONE CIVILE ,11,81,92
2,2024,AIRE,CITTADINANZA,13,145,158
2,2024,AIRE,CONTESTUALE,138,511,649
2,2024,AIRE,ESISTENZA IN VITA,0,2,2
2,2024,AIRE,MATRIMONIO,32,168,200
2,2024,AIRE,NASCITA,185,417,602
2,2024,AIRE,RESIDENZA,140,1047,1187
2,2024,AIRE,STATO CIVILE,4,18,22
2,2024,AIRE,STATO FAMIGLIA,23,301,324
2,2024,AIRE,STATO FAMIGLIA CON RAPPORTI PARENTELA,1,10,11
2,2024,AIRE,STATO FAMIGLIA E STATO CIVILE,0,8,8
2,2024,AIRE,STATO LIBERO,2,6,8
2,2024,AIRE,UNIONE CIVILE ,1,2,3
2,2024,Residenti,CITTADINANZA,121,2777,2898
2,2024,Residenti,CONTESTUALE,13359,118325,131684
2,2024,Residenti,CONTRATTO CONVIVENZA,3,20,23
2,2024,Residenti,ESISTENZA IN VITA,181,3887,4068
2,2024,Residenti,MATRIMONIO,1277,18828,20105
2,2024,Residenti,NASCITA,1749,19831,21580
2,2024,Residenti,RESIDENZA,5831,270537,276368
2,2024,Residenti,RESIDENZA IN CONVIVENZA,4,212,216
2,2024,Residenti,STATO CIVILE,2149,17123,19272
2,2024,Residenti,STATO FAMIGLIA,7077,92584,99661
2,2024,Residenti,STATO FAMIGLIA CON RAPPORTI PARENTELA,861,11626,12487
2,2024,Residenti,STATO FAMIGLIA E STATO CIVILE,1039,10538,11577
2,2024,Residenti,STATO LIBERO,2396,5528,7924
2,2024,Residenti,UNIONE CIVILE ,10,90,100
3,2024,AIRE,CITTADINANZA,9,112,121
3,2024,AIRE,CONTESTUALE,144,614,758
3,2024,AIRE,ESISTENZA IN VITA,0,1,1
3,2024,AIRE,GODIMENTO DEI DIRITTI POLITICI,0,9,9
3,2024,AIRE,ISCRIZIONE NELLE LISTE ELETTORALI,2,13,15
3,2024,AIRE,MATRIMONIO,23,198,221
3,2024,AIRE,NASCITA,181,455,636
3,2024,AIRE,RESIDENZA,163,1140,1303
3,2024,AIRE,STATO CIVILE,4,13,17
3,2024,AIRE,STATO FAMIGLIA,27,297,324
3,2024,AIRE,STATO FAMIGLIA CON RAPPORTI PARENTELA,1,3,4
3,2024,AIRE,STATO FAMIGLIA E STATO CIVILE,1,11,12
3,2024,AIRE,STATO LIBERO,5,7,12
3,2024,AIRE,UNIONE CIVILE ,1,5,6
3,2024,Residenti,CITTADINANZA,163,2819,2982
3,2024,Residenti,CONTESTUALE,17101,124818,141919
3,2024,Residenti,CONTRATTO CONVIVENZA,4,16,20
3,2024,Residenti,ESISTENZA IN VITA,182,3352,3534
3,2024,Residenti,GODIMENTO DEI DIRITTI POLITICI,53,281,334
3,2024,Residenti,ISCRIZIONE NELLE LISTE ELETTORALI,15,800,815
3,2024,Residenti,MATRIMONIO,1351,18001,19352
3,2024,Residenti,NASCITA,1711,19332,21043
3,2024,Residenti,RESIDENZA,6089,268376,274465
3,2024,Residenti,RESIDENZA IN CONVIVENZA,4,223,227
3,2024,Residenti,STATO CIVILE,2132,16832,18964
3,2024,Residenti,STATO FAMIGLIA,6718,84523,91241
3,2024,Residenti,STATO FAMIGLIA CON RAPPORTI PARENTELA,860,10376,11236
3,2024,Residenti,STATO FAMIGLIA E STATO CIVILE,989,9527,10516
3,2024,Residenti,STATO LIBERO,2453,5508,7961
3,2024,Residenti,UNIONE CIVILE ,7,90,97
4,2024,AIRE,CITTADINANZA,18,135,153
4,2024,AIRE,CONTESTUALE,149,612,761
4,2024,AIRE,ESISTENZA IN VITA,0,2,2
4,2024,AIRE,GODIMENTO DEI DIRITTI POLITICI,2,10,12
4,2024,AIRE,ISCRIZIONE NELLE LISTE ELETTORALI,3,16,19
4,2024,AIRE,MATRIMONIO,30,171,201
4,2024,AIRE,NASCITA,154,422,576
4,2024,AIRE,RESIDENZA,198,1117,1315
4,2024,AIRE,STATO CIVILE,3,9,12
4,2024,AIRE,STATO FAMIGLIA,42,277,319
4,2024,AIRE,STATO FAMIGLIA CON RAPPORTI PARENTELA,0,6,6
4,2024,AIRE,STATO FAMIGLIA E STATO CIVILE,0,12,12
4,2024,AIRE,STATO LIBERO,1,4,5
4,2024,AIRE,UNIONE CIVILE ,1,0,1
4,2024,Residenti,CITTADINANZA,118,2803,2921
4,2024,Residenti,CONTESTUALE,13867,117397,131264
4,2024,Residenti,CONTRATTO CONVIVENZA,3,16,19
4,2024,Residenti,ESISTENZA IN VITA,170,3140,3310
4,2024,Residenti,GODIMENTO DEI DIRITTI POLITICI,66,785,851
4,2024,Residenti,ISCRIZIONE NELLE LISTE ELETTORALI,110,7678,7788
4,2024,Residenti,MATRIMONIO,1310,17756,19066
4,2024,Residenti,NASCITA,1812,18595,20407
4,2024,Residenti,RESIDENZA,5750,258618,264368
4,2024,Residenti,RESIDENZA IN CONVIVENZA,2,210,212
4,2024,Residenti,STATO CIVILE,2179,16392,18571
4,2024,Residenti,STATO FAMIGLIA,6335,79220,85555
4,2024,Residenti,STATO FAMIGLIA CON RAPPORTI PARENTELA,814,9541,10355
4,2024,Residenti,STATO FAMIGLIA E STATO CIVILE,936,9147,10083
4,2024,Residenti,STATO LIBERO,2564,5448,8012
4,2024,Residenti,UNIONE CIVILE ,15,78,93
5,2024,AIRE,CITTADINANZA,17,113,130
5,2024,AIRE,CONTESTUALE,134,679,813
5,2024,AIRE,ESISTENZA IN VITA,0,3,3
5,2024,AIRE,GODIMENTO DEI DIRITTI POLITICI,1,9,10
5,2024,AIRE,ISCRIZIONE NELLE LISTE ELETTORALI,4,57,61
5,2024,AIRE,MATRIMONIO,29,212,241
5,2024,AIRE,NASCITA,147,379,526
5,2024,AIRE,RESIDENZA,162,1131,1293
5,2024,AIRE,STATO CIVILE,5,20,25
5,2024,AIRE,STATO FAMIGLIA,47,295,342
5,2024,AIRE,STATO FAMIGLIA CON RAPPORTI PARENTELA,0,1,1
5,2024,AIRE,STATO FAMIGLIA E STATO CIVILE,1,3,4
5,2024,AIRE,STATO LIBERO,1,3,4
5,2024,AIRE,UNIONE CIVILE ,2,5,7
5,2024,Residenti,CITTADINANZA,120,3183,3303
5,2024,Residenti,CONTESTUALE,14824,134238,149062
5,2024,Residenti,CONTRATTO CONVIVENZA,4,21,25
5,2024,Residenti,ESISTENZA IN VITA,194,3582,3776
5,2024,Residenti,GODIMENTO DEI DIRITTI POLITICI,101,1183,1284
5,2024,Residenti,ISCRIZIONE NELLE LISTE ELETTORALI,95,7997,8092
5,2024,Residenti,MATRIMONIO,1743,20567,22310
5,2024,Residenti,NASCITA,1833,21910,23743
5,2024,Residenti,RESIDENZA,6093,297218,303311
5,2024,Residenti,RESIDENZA IN CONVIVENZA,4,174,178
5,2024,Residenti,STATO CIVILE,2699,19604,22303
5,2024,Residenti,STATO FAMIGLIA,7244,90473,97717
5,2024,Residenti,STATO FAMIGLIA CON RAPPORTI PARENTELA,969,11060,12029
5,2024,Residenti,STATO FAMIGLIA E STATO CIVILE,1099,9914,11013
5,2024,Residenti,STATO LIBERO,2891,6631,9522
5,2024,Residenti,UNIONE CIVILE ,13,87,100
6,2024,AIRE,CITTADINANZA,13,106,119
6,2024,AIRE,CONTESTUALE,123,632,755
6,2024,AIRE,ESISTENZA IN VITA,0,6,6
6,2024,AIRE,GODIMENTO DEI DIRITTI POLITICI,0,5,5
6,2024,AIRE,ISCRIZIONE NELLE LISTE ELETTORALI,2,70,72
6,2024,AIRE,MATRIMONIO,40,177,217
6,2024,AIRE,NASCITA,172,348,520
6,2024,AIRE,RESIDENZA,169,920,1089
6,2024,AIRE,STATO CIVILE,2,9,11
6,2024,AIRE,STATO FAMIGLIA,44,309,353
6,2024,AIRE,STATO FAMIGLIA CON RAPPORTI PARENTELA,0,6,6
6,2024,AIRE,STATO FAMIGLIA E STATO CIVILE,1,4,5
6,2024,AIRE,STATO LIBERO,2,3,5
6,2024,AIRE,UNIONE CIVILE ,0,3,3
6,2024,Residenti,CITTADINANZA,136,2701,2837
6,2024,Residenti,CONTESTUALE,11536,117561,129097
6,2024,Residenti,CONTRATTO CONVIVENZA,1,20,21
6,2024,Residenti,ESISTENZA IN VITA,172,3299,3471
6,2024,Residenti,GODIMENTO DEI DIRITTI POLITICI,95,1145,1240
6,2024,Residenti,ISCRIZIONE NELLE LISTE ELETTORALI,27,2017,2044
6,2024,Residenti,MATRIMONIO,1788,18123,19911
6,2024,Residenti,NASCITA,1684,17369,19053
6,2024,Residenti,RESIDENZA,5446,262537,267983
6,2024,Residenti,RESIDENZA IN CONVIVENZA,1,163,164
6,2024,Residenti,STATO CIVILE,2314,17577,19891
6,2024,Residenti,STATO FAMIGLIA,6589,78704,85293
6,2024,Residenti,STATO FAMIGLIA CON RAPPORTI PARENTELA,839,9247,10086
6,2024,Residenti,STATO FAMIGLIA E STATO CIVILE,979,8505,9484
6,2024,Residenti,STATO LIBERO,2442,5776,8218
6,2024,Residenti,UNIONE CIVILE ,19,79,98
7,2024,AIRE,CITTADINANZA,13,124,137
7,2024,AIRE,CONTESTUALE,112,583,695
7,2024,AIRE,ESISTENZA IN VITA,0,2,2
7,2024,AIRE,GODIMENTO DEI DIRITTI POLITICI,1,5,6
7,2024,AIRE,ISCRIZIONE NELLE LISTE ELETTORALI,0,7,7
7,2024,AIRE,MATRIMONIO,37,163,200
7,2024,AIRE,NASCITA,184,347,531
7,2024,AIRE,RESIDENZA,186,1057,1243
7,2024,AIRE,STATO CIVILE,9,10,19
7,2024,AIRE,STATO FAMIGLIA,51,321,372
7,2024,AIRE,STATO FAMIGLIA CON RAPPORTI PARENTELA,1,1,2
7,2024,AIRE,STATO FAMIGLIA E STATO CIVILE,0,1,1
7,2024,AIRE,STATO LIBERO,0,4,4
7,2024,AIRE,UNIONE CIVILE ,0,1,1
7,2024,Residenti,CITTADINANZA,142,2923,3065
7,2024,Residenti,CONTESTUALE,12093,151200,163293
7,2024,Residenti,CONTRATTO CONVIVENZA,3,23,26
7,2024,Residenti,ESISTENZA IN VITA,169,3623,3792
7,2024,Residenti,GODIMENTO DEI DIRITTI POLITICI,118,244,362
7,2024,Residenti,ISCRIZIONE NELLE LISTE ELETTORALI,24,211,235
7,2024,Residenti,MATRIMONIO,1890,19848,21738
7,2024,Residenti,NASCITA,1818,19104,20922
7,2024,Residenti,RESIDENZA,6206,286855,293061
7,2024,Residenti,RESIDENZA IN CONVIVENZA,5,186,191
7,2024,Residenti,STATO CIVILE,2371,18409,20780
7,2024,Residenti,STATO FAMIGLIA,7049,88633,95682
7,2024,Residenti,STATO FAMIGLIA CON RAPPORTI PARENTELA,989,10302,11291
7,2024,Residenti,STATO FAMIGLIA E STATO CIVILE,1084,8991,10075
7,2024,Residenti,STATO LIBERO,2570,5939,8509
7,2024,Residenti,UNIONE CIVILE ,23,77,100
8,2024,AIRE,CITTADINANZA,29,92,121
8,2024,AIRE,CONTESTUALE,93,426,519
8,2024,AIRE,GODIMENTO DEI DIRITTI POLITICI,1,5,6
8,2024,AIRE,ISCRIZIONE NELLE LISTE ELETTORALI,0,5,5
8,2024,AIRE,MATRIMONIO,24,160,184
8,2024,AIRE,NASCITA,180,353,533
8,2024,AIRE,RESIDENZA,126,714,840
8,2024,AIRE,STATO CIVILE,1,6,7
8,2024,AIRE,STATO FAMIGLIA,41,229,270
8,2024,AIRE,STATO FAMIGLIA E STATO CIVILE,0,2,2
8,2024,AIRE,STATO LIBERO,1,2,3
8,2024,AIRE,UNIONE CIVILE ,1,1,2
8,2024,Residenti,CITTADINANZA,113,2053,2166
8,2024,Residenti,CONTESTUALE,6952,83186,90138
8,2024,Residenti,CONTRATTO CONVIVENZA,2,15,17
8,2024,Residenti,ESISTENZA IN VITA,101,1723,1824
8,2024,Residenti,GODIMENTO DEI DIRITTI POLITICI,56,166,222
8,2024,Residenti,ISCRIZIONE NELLE LISTE ELETTORALI,22,299,321
8,2024,Residenti,MATRIMONIO,929,9356,10285
8,2024,Residenti,NASCITA,1453,12723,14176
8,2024,Residenti,RESIDENZA,4393,134691,139084
8,2024,Residenti,RESIDENZA IN CONVIVENZA,2,84,86
8,2024,Residenti,STATO CIVILE,864,8470,9334
8,2024,Residenti,STATO FAMIGLIA,4254,52960,57214
8,2024,Residenti,STATO FAMIGLIA CON RAPPORTI PARENTELA,636,6843,7479
8,2024,Residenti,STATO FAMIGLIA E STATO CIVILE,559,5336,5895
8,2024,Residenti,STATO LIBERO,942,2294,3236
8,2024,Residenti,UNIONE CIVILE ,9,55,64
9,2024,AIRE,CITTADINANZA,16,125,141
9,2024,AIRE,CONTESTUALE,129,586,715
9,2024,AIRE,ESISTENZA IN VITA,0,1,1
9,2024,AIRE,GODIMENTO DEI DIRITTI POLITICI,1,1,2
9,2024,AIRE,ISCRIZIONE NELLE LISTE ELETTORALI,1,11,12
9,2024,AIRE,MATRIMONIO,53,210,263
9,2024,AIRE,NASCITA,180,433,613
9,2024,AIRE,RESIDENZA,163,999,1162
9,2024,AIRE,STATO CIVILE,1,14,15
9,2024,AIRE,STATO FAMIGLIA,44,316,360
9,2024,AIRE,STATO FAMIGLIA CON RAPPORTI PARENTELA,0,3,3
9,2024,AIRE,STATO FAMIGLIA E STATO CIVILE,0,4,4
9,2024,AIRE,STATO LIBERO,2,4,6
9,2024,AIRE,UNIONE CIVILE ,3,0,3
9,2024,Residenti,CITTADINANZA,150,3363,3513
9,2024,Residenti,CONTESTUALE,13061,203335,216396
9,2024,Residenti,CONTRATTO CONVIVENZA,5,20,25
9,2024,Residenti,ESISTENZA IN VITA,199,3430,3629
9,2024,Residenti,GODIMENTO DEI DIRITTI POLITICI,82,279,361
9,2024,Residenti,ISCRIZIONE NELLE LISTE ELETTORALI,15,335,350
9,2024,Residenti,MATRIMONIO,1932,19850,21782
9,2024,Residenti,NASCITA,1913,21822,23735
9,2024,Residenti,RESIDENZA,6336,293460,299796
9,2024,Residenti,RESIDENZA IN CONVIVENZA,3,217,220
9,2024,Residenti,STATO CIVILE,2554,18712,21266
9,2024,Residenti,STATO FAMIGLIA,7300,104345,111645
9,2024,Residenti,STATO FAMIGLIA CON RAPPORTI PARENTELA,953,11809,12762
9,2024,Residenti,STATO FAMIGLIA E STATO CIVILE,1014,9862,10876
9,2024,Residenti,STATO LIBERO,2630,6039,8669
9,2024,Residenti,UNIONE CIVILE ,20,93,113
10,2024,AIRE,CITTADINANZA,18,101,119
10,2024,AIRE,CONTESTUALE,135,647,782
10,2024,AIRE,ESISTENZA IN VITA,0,2,2
10,2024,AIRE,GODIMENTO DEI DIRITTI POLITICI,0,1,1
10,2024,AIRE,ISCRIZIONE NELLE LISTE ELETTORALI,0,6,6
10,2024,AIRE,MATRIMONIO,41,218,259
10,2024,AIRE,NASCITA,199,451,650
10,2024,AIRE,RESIDENZA,219,1258,1477
10,2024,AIRE,STATO CIVILE,6,5,11
10,2024,AIRE,STATO FAMIGLIA,39,327,366
10,2024,AIRE,STATO FAMIGLIA CON RAPPORTI PARENTELA,0,2,2
10,2024,AIRE,STATO FAMIGLIA E STATO CIVILE,0,1,1
10,2024,AIRE,STATO LIBERO,2,5,7
10,2024,AIRE,UNIONE CIVILE ,0,1,1
10,2024,Residenti,CITTADINANZA,169,3614,3783
10,2024,Residenti,CONTESTUALE,15398,190904,206302
10,2024,Residenti,CONTRATTO CONVIVENZA,0,23,23
10,2024,Residenti,ESISTENZA IN VITA,256,4050,4306
10,2024,Residenti,GODIMENTO DEI DIRITTI POLITICI,53,264,317
10,2024,Residenti,ISCRIZIONE NELLE LISTE ELETTORALI,16,657,673
10,2024,Residenti,MATRIMONIO,2284,23428,25712
10,2024,Residenti,NASCITA,1830,22455,24285
10,2024,Residenti,RESIDENZA,7435,335725,343160
10,2024,Residenti,RESIDENZA IN CONVIVENZA,5,229,234
10,2024,Residenti,STATO CIVILE,2857,21568,24425
10,2024,Residenti,STATO FAMIGLIA,8319,105134,113453
10,2024,Residenti,STATO FAMIGLIA CON RAPPORTI PARENTELA,1055,11966,13021
10,2024,Residenti,STATO FAMIGLIA E STATO CIVILE,1287,10681,11968
10,2024,Residenti,STATO LIBERO,3100,6741,9841
10,2024,Residenti,UNIONE CIVILE ,21,110,131
11,2024,AIRE,CITTADINANZA,26,99,125
11,2024,AIRE,CONTESTUALE,148,600,748
11,2024,AIRE,GODIMENTO DEI DIRITTI POLITICI,0,8,8
11,2024,AIRE,ISCRIZIONE NELLE LISTE ELETTORALI,0,3,3
11,2024,AIRE,MATRIMONIO,51,204,255
11,2024,AIRE,NASCITA,201,435,636
11,2024,AIRE,RESIDENZA,155,1122,1277
11,2024,AIRE,STATO CIVILE,2,3,5
11,2024,AIRE,STATO FAMIGLIA,51,300,351
11,2024,AIRE,STATO FAMIGLIA CON RAPPORTI PARENTELA,0,3,3
11,2024,AIRE,STATO FAMIGLIA E STATO CIVILE,3,4,7
11,2024,AIRE,STATO LIBERO,0,6,6
11,2024,AIRE,UNIONE CIVILE ,1,2,3
11,2024,Residenti,CITTADINANZA,109,3168,3277
11,2024,Residenti,CONTESTUALE,12782,144203,156985
11,2024,Residenti,CONTRATTO CONVIVENZA,2,19,21
11,2024,Residenti,ESISTENZA IN VITA,188,3337,3525
11,2024,Residenti,GODIMENTO DEI DIRITTI POLITICI,118,225,343
11,2024,Residenti,ISCRIZIONE NELLE LISTE ELETTORALI,15,259,274
11,2024,Residenti,MATRIMONIO,1635,19653,21288
11,2024,Residenti,NASCITA,1610,18984,20594
11,2024,Residenti,RESIDENZA,6221,300891,307112
11,2024,Residenti,RESIDENZA IN CONVIVENZA,5,221,226
11,2024,Residenti,STATO CIVILE,2778,19029,21807
11,2024,Residenti,STATO FAMIGLIA,6525,89315,95840
11,2024,Residenti,STATO FAMIGLIA CON RAPPORTI PARENTELA,825,11126,11951
11,2024,Residenti,STATO FAMIGLIA E STATO CIVILE,1004,9336,10340
11,2024,Residenti,STATO LIBERO,3012,6504,9516
11,2024,Residenti,UNIONE CIVILE ,18,85,103
12,2024,AIRE,CITTADINANZA,13,123,136
12,2024,AIRE,CONTESTUALE,102,543,645
12,2024,AIRE,ESISTENZA IN VITA,0,1,1
12,2024,AIRE,GODIMENTO DEI DIRITTI POLITICI,2,5,7
12,2024,AIRE,ISCRIZIONE NELLE LISTE ELETTORALI,0,7,7
12,2024,AIRE,MATRIMONIO,38,182,220
12,2024,AIRE,NASCITA,163,359,522
12,2024,AIRE,RESIDENZA,163,1149,1312
12,2024,AIRE,STATO CIVILE,1,4,5
12,2024,AIRE,STATO FAMIGLIA,47,298,345
12,2024,AIRE,STATO FAMIGLIA E STATO CIVILE,0,1,1
12,2024,AIRE,STATO LIBERO,1,0,1
12,2024,AIRE,UNIONE CIVILE ,1,0,1
12,2024,Residenti,CITTADINANZA,101,2878,2979
12,2024,Residenti,CONTESTUALE,9693,108713,118406
12,2024,Residenti,CONTRATTO CONVIVENZA,4,17,21
12,2024,Residenti,ESISTENZA IN VITA,168,2958,3126
12,2024,Residenti,GODIMENTO DEI DIRITTI POLITICI,67,180,247
12,2024,Residenti,ISCRIZIONE NELLE LISTE ELETTORALI,11,167,178
12,2024,Residenti,MATRIMONIO,1264,15347,16611
12,2024,Residenti,NASCITA,1513,15803,17316
12,2024,Residenti,RESIDENZA,5249,241649,246898
12,2024,Residenti,RESIDENZA IN CONVIVENZA,2,146,148
12,2024,Residenti,STATO CIVILE,2064,14478,16542
12,2024,Residenti,STATO FAMIGLIA,5610,69298,74908
12,2024,Residenti,STATO FAMIGLIA CON RAPPORTI PARENTELA,828,8685,9513
12,2024,Residenti,STATO FAMIGLIA E STATO CIVILE,844,7281,8125
12,2024,Residenti,STATO LIBERO,2199,4507,6706
12,2024,Residenti,UNIONE CIVILE ,9,71,80