MESE,ANNO,TIPO_SOGGETTO,TIPOLOGIA_CERTIFICATO,BOLLO,ESENTI_DA_BOLLO,TOTALE
11,2021,AIRE,CITTADINANZA,293,191,484
11,2021,AIRE,CONTESTUALE,913,814,1727
11,2021,AIRE,ESISTENZA IN VITA,3,0,3
11,2021,AIRE,MATRIMONIO,222,270,492
11,2021,AIRE,NASCITA,448,380,828
11,2021,AIRE,RESIDENZA,645,694,1339
11,2021,AIRE,STATO CIVILE,11,4,15
11,2021,AIRE,STATO FAMIGLIA,360,410,770
11,2021,AIRE,STATO FAMIGLIA CON RAPPORTI PARENTELA,2,0,2
11,2021,AIRE,STATO FAMIGLIA E STATO CIVILE,6,2,8
11,2021,AIRE,STATO LIBERO,5,1,6
11,2021,AIRE,UNIONE CIVILE ,0,4,4
11,2021,Residenti,CITTADINANZA,4968,3810,8778
11,2021,Residenti,CONTESTUALE,52358,54343,106701
11,2021,Residenti,CONTRATTO CONVIVENZA,24,11,35
11,2021,Residenti,ESISTENZA IN VITA,4463,4941,9404
11,2021,Residenti,MATRIMONIO,14119,21308,35427
11,2021,Residenti,NASCITA,21978,29843,51821
11,2021,Residenti,RESIDENZA,40072,51727,91799
11,2021,Residenti,RESIDENZA IN CONVIVENZA,47,63,110
11,2021,Residenti,STATO CIVILE,11072,11856,22928
11,2021,Residenti,STATO FAMIGLIA,35623,48878,84501
11,2021,Residenti,STATO FAMIGLIA CON RAPPORTI PARENTELA,12199,15361,27560
11,2021,Residenti,STATO FAMIGLIA E STATO CIVILE,11157,13999,25156
11,2021,Residenti,STATO LIBERO,5466,3735,9201
11,2021,Residenti,UNIONE CIVILE ,178,158,336
12,2021,AIRE,CITTADINANZA,155,104,259
12,2021,AIRE,CONTESTUALE,451,306,757
12,2021,AIRE,ESISTENZA IN VITA,4,0,4
12,2021,AIRE,MATRIMONIO,177,140,317
12,2021,AIRE,NASCITA,308,242,550
12,2021,AIRE,RESIDENZA,426,401,827
12,2021,AIRE,STATO CIVILE,6,2,8
12,2021,AIRE,STATO FAMIGLIA,230,216,446
12,2021,AIRE,STATO FAMIGLIA CON RAPPORTI PARENTELA,0,2,2
12,2021,AIRE,STATO FAMIGLIA E STATO CIVILE,4,2,6
12,2021,AIRE,STATO LIBERO,2,0,2
12,2021,AIRE,UNIONE CIVILE ,2,3,5
12,2021,Residenti,CITTADINANZA,3230,1403,4633
12,2021,Residenti,CONTESTUALE,35881,30919,66800
12,2021,Residenti,CONTRATTO CONVIVENZA,7,6,13
12,2021,Residenti,ESISTENZA IN VITA,2617,2025,4642
12,2021,Residenti,MATRIMONIO,8809,9432,18241
12,2021,Residenti,NASCITA,12047,11059,23106
12,2021,Residenti,RESIDENZA,31704,35686,67390
12,2021,Residenti,RESIDENZA IN CONVIVENZA,37,30,67
12,2021,Residenti,STATO CIVILE,8769,7210,15979
12,2021,Residenti,STATO FAMIGLIA,29070,33604,62674
12,2021,Residenti,STATO FAMIGLIA CON RAPPORTI PARENTELA,7597,7143,14740
12,2021,Residenti,STATO FAMIGLIA E STATO CIVILE,7130,6231,13361
12,2021,Residenti,STATO LIBERO,5044,3008,8052
12,2021,Residenti,UNIONE CIVILE ,37,39,76
1,2022,AIRE,CITTADINANZA,150,88,238
1,2022,AIRE,CONTESTUALE,375,316,691
1,2022,AIRE,ESISTENZA IN VITA,0,1,1
1,2022,AIRE,MATRIMONIO,113,132,245
1,2022,AIRE,NASCITA,319,279,598
1,2022,AIRE,RESIDENZA,316,336,652
1,2022,AIRE,STATO CIVILE,6,6,12
1,2022,AIRE,STATO FAMIGLIA,189,214,403
1,2022,AIRE,STATO FAMIGLIA CON RAPPORTI PARENTELA,3,2,5
1,2022,AIRE,STATO FAMIGLIA E STATO CIVILE,1,1,2
1,2022,AIRE,STATO LIBERO,5,2,7
1,2022,AIRE,UNIONE CIVILE ,1,2,3
1,2022,Residenti,CITTADINANZA,1749,1568,3317
1,2022,Residenti,CONTESTUALE,39606,39453,79059
1,2022,Residenti,CONTRATTO CONVIVENZA,19,9,28
1,2022,Residenti,ESISTENZA IN VITA,1682,2247,3929
1,2022,Residenti,MATRIMONIO,8091,10957,19048
1,2022,Residenti,NASCITA,11236,12618,23854
1,2022,Residenti,RESIDENZA,36072,47648,83720
1,2022,Residenti,RESIDENZA IN CONVIVENZA,46,41,87
1,2022,Residenti,STATO CIVILE,8082,8848,16930
1,2022,Residenti,STATO FAMIGLIA,47662,61283,108945
1,2022,Residenti,STATO FAMIGLIA CON RAPPORTI PARENTELA,8205,10512,18717
1,2022,Residenti,STATO FAMIGLIA E STATO CIVILE,7434,8972,16406
1,2022,Residenti,STATO LIBERO,5083,3633,8716
1,2022,Residenti,UNIONE CIVILE ,35,40,75
2,2022,AIRE,CITTADINANZA,102,76,178
2,2022,AIRE,CONTESTUALE,330,330,660
2,2022,AIRE,ESISTENZA IN VITA,1,1,2
2,2022,AIRE,MATRIMONIO,105,135,240
2,2022,AIRE,NASCITA,302,249,551
2,2022,AIRE,RESIDENZA,319,339,658
2,2022,AIRE,STATO CIVILE,1,7,8
2,2022,AIRE,STATO FAMIGLIA,187,189,376
2,2022,AIRE,STATO FAMIGLIA CON RAPPORTI PARENTELA,0,5,5
2,2022,AIRE,STATO FAMIGLIA E STATO CIVILE,2,3,5
2,2022,AIRE,STATO LIBERO,0,1,1
2,2022,AIRE,UNIONE CIVILE ,4,2,6
2,2022,Residenti,CITTADINANZA,1772,1445,3217
2,2022,Residenti,CONTESTUALE,41708,40169,81877
2,2022,Residenti,CONTRATTO CONVIVENZA,11,9,20
2,2022,Residenti,ESISTENZA IN VITA,1326,1683,3009
2,2022,Residenti,MATRIMONIO,8488,11230,19718
2,2022,Residenti,NASCITA,10204,11625,21829
2,2022,Residenti,RESIDENZA,32816,42311,75127
2,2022,Residenti,RESIDENZA IN CONVIVENZA,45,41,86
2,2022,Residenti,STATO CIVILE,8721,9665,18386
2,2022,Residenti,STATO FAMIGLIA,37460,48947,86407
2,2022,Residenti,STATO FAMIGLIA CON RAPPORTI PARENTELA,6520,8470,14990
2,2022,Residenti,STATO FAMIGLIA E STATO CIVILE,6636,7888,14524
2,2022,Residenti,STATO LIBERO,5880,4489,10369
2,2022,Residenti,UNIONE CIVILE ,42,39,81
3,2022,AIRE,CITTADINANZA,98,84,182
3,2022,AIRE,CONTESTUALE,347,329,676
3,2022,AIRE,ESISTENZA IN VITA,0,1,1
3,2022,AIRE,MATRIMONIO,99,127,226
3,2022,AIRE,NASCITA,292,288,580
3,2022,AIRE,RESIDENZA,267,336,603
3,2022,AIRE,STATO CIVILE,7,13,20
3,2022,AIRE,STATO FAMIGLIA,186,205,391
3,2022,AIRE,STATO FAMIGLIA CON RAPPORTI PARENTELA,6,0,6
3,2022,AIRE,STATO FAMIGLIA E STATO CIVILE,5,4,9
3,2022,AIRE,STATO LIBERO,4,4,8
3,2022,AIRE,UNIONE CIVILE ,7,1,8
3,2022,Residenti,CITTADINANZA,2091,1407,3498
3,2022,Residenti,CONTESTUALE,46139,42873,89012
3,2022,Residenti,CONTRATTO CONVIVENZA,7,9,16
3,2022,Residenti,ESISTENZA IN VITA,1397,1510,2907
3,2022,Residenti,MATRIMONIO,9400,12224,21624
3,2022,Residenti,NASCITA,11122,12295,23417
3,2022,Residenti,RESIDENZA,37415,46506,83921
3,2022,Residenti,RESIDENZA IN CONVIVENZA,57,44,101
3,2022,Residenti,STATO CIVILE,9847,10097,19944
3,2022,Residenti,STATO FAMIGLIA,36243,46076,82319
3,2022,Residenti,STATO FAMIGLIA CON RAPPORTI PARENTELA,6492,8224,14716
3,2022,Residenti,STATO FAMIGLIA E STATO CIVILE,6732,7669,14401
3,2022,Residenti,STATO LIBERO,6607,5063,11670
3,2022,Residenti,UNIONE CIVILE ,40,48,88
4,2022,AIRE,CITTADINANZA,96,87,183
4,2022,AIRE,CONTESTUALE,346,283,629
4,2022,AIRE,ESISTENZA IN VITA,1,1,2
4,2022,AIRE,MATRIMONIO,71,120,191
4,2022,AIRE,NASCITA,273,228,501
4,2022,AIRE,RESIDENZA,341,448,789
4,2022,AIRE,STATO CIVILE,4,4,8
4,2022,AIRE,STATO FAMIGLIA,160,204,364
4,2022,AIRE,STATO FAMIGLIA CON RAPPORTI PARENTELA,0,6,6
4,2022,AIRE,STATO FAMIGLIA E STATO CIVILE,3,2,5
4,2022,AIRE,STATO LIBERO,1,4,5
4,2022,AIRE,UNIONE CIVILE ,0,2,2
4,2022,Residenti,CITTADINANZA,1640,1204,2844
4,2022,Residenti,CONTESTUALE,36764,34738,71502
4,2022,Residenti,CONTRATTO CONVIVENZA,9,4,13
4,2022,Residenti,ESISTENZA IN VITA,1052,1285,2337
4,2022,Residenti,MATRIMONIO,7541,9512,17053
4,2022,Residenti,NASCITA,9166,9979,19145
4,2022,Residenti,RESIDENZA,32073,39935,72008
4,2022,Residenti,RESIDENZA IN CONVIVENZA,47,45,92
4,2022,Residenti,STATO CIVILE,7785,8352,16137
4,2022,Residenti,STATO FAMIGLIA,27806,34681,62487
4,2022,Residenti,STATO FAMIGLIA CON RAPPORTI PARENTELA,5307,6372,11679
4,2022,Residenti,STATO FAMIGLIA E STATO CIVILE,5329,5973,11302
4,2022,Residenti,STATO LIBERO,5495,4270,9765
4,2022,Residenti,UNIONE CIVILE ,51,36,87
5,2022,AIRE,CITTADINANZA,112,86,198
5,2022,AIRE,CONTESTUALE,395,320,715
5,2022,AIRE,MATRIMONIO,116,138,254
5,2022,AIRE,NASCITA,335,244,579
5,2022,AIRE,RESIDENZA,358,416,774
5,2022,AIRE,STATO CIVILE,8,8,16
5,2022,AIRE,STATO FAMIGLIA,188,189,377
5,2022,AIRE,STATO FAMIGLIA CON RAPPORTI PARENTELA,1,5,6
5,2022,AIRE,STATO FAMIGLIA E STATO CIVILE,3,2,5
5,2022,AIRE,STATO LIBERO,4,3,7
5,2022,AIRE,UNIONE CIVILE ,0,1,1
5,2022,Residenti,CITTADINANZA,1764,1367,3131
5,2022,Residenti,CONTESTUALE,40303,38784,79087
5,2022,Residenti,CONTRATTO CONVIVENZA,19,7,26
5,2022,Residenti,ESISTENZA IN VITA,1171,1377,2548
5,2022,Residenti,MATRIMONIO,8372,11039,19411
5,2022,Residenti,NASCITA,9860,11386,21246
5,2022,Residenti,RESIDENZA,38623,46708,85331
5,2022,Residenti,RESIDENZA IN CONVIVENZA,43,52,95
5,2022,Residenti,STATO CIVILE,9325,9933,19258
5,2022,Residenti,STATO FAMIGLIA,33293,41467,74760
5,2022,Residenti,STATO FAMIGLIA CON RAPPORTI PARENTELA,5999,7392,13391
5,2022,Residenti,STATO FAMIGLIA E STATO CIVILE,6024,6940,12964
5,2022,Residenti,STATO LIBERO,6299,4991,11290
5,2022,Residenti,UNIONE CIVILE ,38,33,71
6,2022,AIRE,CITTADINANZA,123,82,205
6,2022,AIRE,CONTESTUALE,321,257,578
6,2022,AIRE,MATRIMONIO,85,101,186
6,2022,AIRE,NASCITA,285,226,511
6,2022,AIRE,RESIDENZA,291,381,672
6,2022,AIRE,STATO CIVILE,6,6,12
6,2022,AIRE,STATO FAMIGLIA,176,209,385
6,2022,AIRE,STATO FAMIGLIA CON RAPPORTI PARENTELA,2,5,7
6,2022,AIRE,STATO FAMIGLIA E STATO CIVILE,2,1,3
6,2022,AIRE,STATO LIBERO,4,2,6
6,2022,AIRE,UNIONE CIVILE ,1,0,1
6,2022,Residenti,CITTADINANZA,1799,1390,3189
6,2022,Residenti,CONTESTUALE,37000,37044,74044
6,2022,Residenti,CONTRATTO CONVIVENZA,17,6,23
6,2022,Residenti,ESISTENZA IN VITA,1081,1377,2458
6,2022,Residenti,MATRIMONIO,8440,10567,19007
6,2022,Residenti,NASCITA,9164,10059,19223
6,2022,Residenti,RESIDENZA,35267,43653,78920
6,2022,Residenti,RESIDENZA IN CONVIVENZA,39,44,83
6,2022,Residenti,STATO CIVILE,8924,9559,18483
6,2022,Residenti,STATO FAMIGLIA,30464,38091,68555
6,2022,Residenti,STATO FAMIGLIA CON RAPPORTI PARENTELA,5612,6728,12340
6,2022,Residenti,STATO FAMIGLIA E STATO CIVILE,5340,6399,11739
6,2022,Residenti,STATO LIBERO,5703,4750,10453
6,2022,Residenti,UNIONE CIVILE ,41,40,81
7,2022,AIRE,CITTADINANZA,94,76,170
7,2022,AIRE,CONTESTUALE,300,262,562
7,2022,AIRE,ESISTENZA IN VITA,2,0,2
7,2022,AIRE,MATRIMONIO,109,121,230
7,2022,AIRE,NASCITA,264,223,487
7,2022,AIRE,RESIDENZA,320,367,687
7,2022,AIRE,STATO CIVILE,6,6,12
7,2022,AIRE,STATO FAMIGLIA,182,188,370
7,2022,AIRE,STATO FAMIGLIA CON RAPPORTI PARENTELA,1,1,2
7,2022,AIRE,STATO FAMIGLIA E STATO CIVILE,1,2,3
7,2022,AIRE,STATO LIBERO,1,0,1
7,2022,AIRE,UNIONE CIVILE ,2,0,2
7,2022,Residenti,CITTADINANZA,1550,1188,2738
7,2022,Residenti,CONTESTUALE,32027,44453,76480
7,2022,Residenti,CONTRATTO CONVIVENZA,15,16,31
7,2022,Residenti,ESISTENZA IN VITA,1043,1299,2342
7,2022,Residenti,MATRIMONIO,8067,9860,17927
7,2022,Residenti,NASCITA,8594,9661,18255
7,2022,Residenti,RESIDENZA,32601,40606,73207
7,2022,Residenti,RESIDENZA IN CONVIVENZA,40,29,69
7,2022,Residenti,STATO CIVILE,7914,8473,16387
7,2022,Residenti,STATO FAMIGLIA,27257,37000,64257
7,2022,Residenti,STATO FAMIGLIA CON RAPPORTI PARENTELA,5206,6562,11768
7,2022,Residenti,STATO FAMIGLIA E STATO CIVILE,4968,5555,10523
7,2022,Residenti,STATO LIBERO,4878,4123,9001
7,2022,Residenti,UNIONE CIVILE ,52,50,102
8,2022,AIRE,CITTADINANZA,104,69,173
8,2022,AIRE,CONTESTUALE,334,271,605
8,2022,AIRE,ESISTENZA IN VITA,2,0,2
8,2022,AIRE,MATRIMONIO,87,87,174
8,2022,AIRE,NASCITA,339,271,610
8,2022,AIRE,RESIDENZA,315,364,679
8,2022,AIRE,STATO CIVILE,5,1,6
8,2022,AIRE,STATO FAMIGLIA,175,179,354
8,2022,AIRE,STATO FAMIGLIA CON RAPPORTI PARENTELA,7,4,11
8,2022,AIRE,STATO FAMIGLIA E STATO CIVILE,1,1,2
8,2022,AIRE,STATO LIBERO,2,0,2
8,2022,AIRE,UNIONE CIVILE ,0,3,3
8,2022,Residenti,CITTADINANZA,1382,1024,2406
8,2022,Residenti,CONTESTUALE,24110,35096,59206
8,2022,Residenti,CONTRATTO CONVIVENZA,13,11,24
8,2022,Residenti,ESISTENZA IN VITA,800,964,1764
8,2022,Residenti,ISCRIZIONE NELLE LISTE ELETTORALI,0,1,1
8,2022,Residenti,MATRIMONIO,5390,6000,11390
8,2022,Residenti,NASCITA,7909,8477,16386
8,2022,Residenti,RESIDENZA,27620,33926,61546
8,2022,Residenti,RESIDENZA IN CONVIVENZA,25,40,65
8,2022,Residenti,STATO CIVILE,4639,5121,9760
8,2022,Residenti,STATO FAMIGLIA,21757,29631,51388
8,2022,Residenti,STATO FAMIGLIA CON RAPPORTI PARENTELA,4245,5404,9649
8,2022,Residenti,STATO FAMIGLIA E STATO CIVILE,3429,4097,7526
8,2022,Residenti,STATO LIBERO,2330,1886,4216
8,2022,Residenti,UNIONE CIVILE ,32,35,67
9,2022,AIRE,CITTADINANZA,127,62,189
9,2022,AIRE,CONTESTUALE,330,290,620
9,2022,AIRE,ESISTENZA IN VITA,3,4,7
9,2022,AIRE,MATRIMONIO,120,125,245
9,2022,AIRE,NASCITA,302,276,578
9,2022,AIRE,RESIDENZA,297,403,700
9,2022,AIRE,STATO CIVILE,11,5,16
9,2022,AIRE,STATO FAMIGLIA,187,197,384
9,2022,AIRE,STATO FAMIGLIA CON RAPPORTI PARENTELA,7,3,10
9,2022,AIRE,STATO FAMIGLIA E STATO CIVILE,3,0,3
9,2022,AIRE,STATO LIBERO,5,4,9
9,2022,Residenti,CITTADINANZA,2251,1877,4128
9,2022,Residenti,CONTESTUALE,42864,85901,128765
9,2022,Residenti,CONTRATTO CONVIVENZA,11,21,32
9,2022,Residenti,ESISTENZA IN VITA,1358,1399,2757
9,2022,Residenti,MATRIMONIO,9567,12016,21583
9,2022,Residenti,NASCITA,11005,14311,25316
9,2022,Residenti,RESIDENZA,40652,53484,94136
9,2022,Residenti,RESIDENZA IN CONVIVENZA,53,59,112
9,2022,Residenti,STATO CIVILE,9360,10153,19513
9,2022,Residenti,STATO FAMIGLIA,35192,55522,90714
9,2022,Residenti,STATO FAMIGLIA CON RAPPORTI PARENTELA,6480,8544,15024
9,2022,Residenti,STATO FAMIGLIA E STATO CIVILE,5688,6986,12674
9,2022,Residenti,STATO LIBERO,5631,4880,10511
9,2022,Residenti,UNIONE CIVILE ,46,62,108
10,2022,AIRE,CITTADINANZA,126,73,199
10,2022,AIRE,CONTESTUALE,346,317,663
10,2022,AIRE,ESISTENZA IN VITA,1,0,1
10,2022,AIRE,MATRIMONIO,112,114,226
10,2022,AIRE,NASCITA,341,269,610
10,2022,AIRE,RESIDENZA,352,388,740
10,2022,AIRE,STATO CIVILE,13,6,19
10,2022,AIRE,STATO FAMIGLIA,197,208,405
10,2022,AIRE,STATO FAMIGLIA CON RAPPORTI PARENTELA,7,5,12
10,2022,AIRE,STATO FAMIGLIA E STATO CIVILE,5,3,8
10,2022,AIRE,STATO LIBERO,6,5,11
10,2022,Residenti,CITTADINANZA,2082,1751,3833
10,2022,Residenti,CONTESTUALE,42133,68150,110283
10,2022,Residenti,CONTRATTO CONVIVENZA,14,17,31
10,2022,Residenti,ESISTENZA IN VITA,1289,1429,2718
10,2022,Residenti,GODIMENTO DEI DIRITTI POLITICI,0,1,1
10,2022,Residenti,ISCRIZIONE NELLE LISTE ELETTORALI,0,1,1
10,2022,Residenti,MATRIMONIO,9493,11655,21148
10,2022,Residenti,NASCITA,10288,12912,23200
10,2022,Residenti,RESIDENZA,40391,52501,92892
10,2022,Residenti,RESIDENZA IN CONVIVENZA,50,50,100
10,2022,Residenti,STATO CIVILE,9053,9910,18963
10,2022,Residenti,STATO FAMIGLIA,35806,50452,86258
10,2022,Residenti,STATO FAMIGLIA CON RAPPORTI PARENTELA,6609,8444,15053
10,2022,Residenti,STATO FAMIGLIA E STATO CIVILE,6136,7375,13511
10,2022,Residenti,STATO LIBERO,5078,4548,9626
10,2022,Residenti,UNIONE CIVILE ,54,48,102
11,2022,AIRE,CITTADINANZA,145,66,211
11,2022,AIRE,CONTESTUALE,381,336,717
11,2022,AIRE,ESISTENZA IN VITA,2,1,3
11,2022,AIRE,MATRIMONIO,118,123,241
11,2022,AIRE,NASCITA,354,270,624
11,2022,AIRE,RESIDENZA,354,346,700
11,2022,AIRE,STATO CIVILE,9,3,12
11,2022,AIRE,STATO FAMIGLIA,204,197,401
11,2022,AIRE,STATO FAMIGLIA CON RAPPORTI PARENTELA,3,2,5
11,2022,AIRE,STATO FAMIGLIA E STATO CIVILE,4,6,10
11,2022,AIRE,STATO LIBERO,1,2,3
11,2022,AIRE,UNIONE CIVILE ,0,1,1
11,2022,Residenti,CITTADINANZA,2261,1693,3954
11,2022,Residenti,CONTESTUALE,40171,50201,90372
11,2022,Residenti,CONTRATTO CONVIVENZA,17,8,25
11,2022,Residenti,ESISTENZA IN VITA,1411,1599,3010
11,2022,Residenti,GODIMENTO DEI DIRITTI POLITICI,0,3,3
11,2022,Residenti,ISCRIZIONE NELLE LISTE ELETTORALI,0,1,1
11,2022,Residenti,MATRIMONIO,8829,11601,20430
11,2022,Residenti,NASCITA,10370,11902,22272
11,2022,Residenti,RESIDENZA,39666,48765,88431
11,2022,Residenti,RESIDENZA IN CONVIVENZA,50,48,98
11,2022,Residenti,STATO CIVILE,9671,10232,19903
11,2022,Residenti,STATO FAMIGLIA,33640,45393,79033
11,2022,Residenti,STATO FAMIGLIA CON RAPPORTI PARENTELA,6884,8583,15467
11,2022,Residenti,STATO FAMIGLIA E STATO CIVILE,5979,6982,12961
11,2022,Residenti,STATO LIBERO,5504,4994,10498
11,2022,Residenti,UNIONE CIVILE ,62,37,99
12,2022,AIRE,CITTADINANZA,173,59,232
12,2022,AIRE,CONTESTUALE,437,311,748
12,2022,AIRE,ESISTENZA IN VITA,1,1,2
12,2022,AIRE,MATRIMONIO,111,113,224
12,2022,AIRE,NASCITA,330,245,575
12,2022,AIRE,RESIDENZA,448,368,816
12,2022,AIRE,STATO CIVILE,8,6,14
12,2022,AIRE,STATO FAMIGLIA,241,187,428
12,2022,AIRE,STATO FAMIGLIA CON RAPPORTI PARENTELA,4,3,7
12,2022,AIRE,STATO FAMIGLIA E STATO CIVILE,2,2,4
12,2022,AIRE,STATO LIBERO,2,1,3
12,2022,AIRE,UNIONE CIVILE ,1,0,1
12,2022,Residenti,CITTADINANZA,2673,1381,4054
12,2022,Residenti,CONTESTUALE,34656,34623,69279
12,2022,Residenti,CONTRATTO CONVIVENZA,18,9,27
12,2022,Residenti,ESISTENZA IN VITA,1955,1538,3493
12,2022,Residenti,MATRIMONIO,7292,8391,15683
12,2022,Residenti,NASCITA,9740,9089,18829
12,2022,Residenti,RESIDENZA,35144,40089,75233
12,2022,Residenti,RESIDENZA IN CONVIVENZA,44,52,96
12,2022,Residenti,STATO CIVILE,8357,7922,16279
12,2022,Residenti,STATO FAMIGLIA,29684,35141,64825
12,2022,Residenti,STATO FAMIGLIA CON RAPPORTI PARENTELA,6634,6778,13412
12,2022,Residenti,STATO FAMIGLIA E STATO CIVILE,5835,5355,11190
12,2022,Residenti,STATO LIBERO,4852,3379,8231
12,2022,Residenti,UNIONE CIVILE ,42,35,77
1,2023,AIRE,CITTADINANZA,13,187,200
1,2023,AIRE,CONTESTUALE,38,827,865
1,2023,AIRE,ESISTENZA IN VITA,0,4,4
1,2023,AIRE,MATRIMONIO,14,221,235
1,2023,AIRE,NASCITA,29,576,605
1,2023,AIRE,RESIDENZA,35,899,934
1,2023,AIRE,STATO CIVILE,2,21,23
1,2023,AIRE,STATO FAMIGLIA,23,417,440
1,2023,AIRE,STATO FAMIGLIA CON RAPPORTI PARENTELA,0,11,11
1,2023,AIRE,STATO FAMIGLIA E STATO CIVILE,0,6,6
1,2023,AIRE,STATO LIBERO,1,10,11
1,2023,AIRE,UNIONE CIVILE ,0,2,2
1,2023,Residenti,CITTADINANZA,136,3172,3308
1,2023,Residenti,CONTESTUALE,2291,90126,92417
1,2023,Residenti,CONTRATTO CONVIVENZA,0,26,26
1,2023,Residenti,ESISTENZA IN VITA,105,2999,3104
1,2023,Residenti,MATRIMONIO,408,17714,18122
1,2023,Residenti,NASCITA,711,22001,22712
1,2023,Residenti,RESIDENZA,2469,93853,96322
1,2023,Residenti,RESIDENZA IN CONVIVENZA,4,116,120
1,2023,Residenti,STATO CIVILE,439,17625,18064
1,2023,Residenti,STATO FAMIGLIA,3224,117476,120700
1,2023,Residenti,STATO FAMIGLIA CON RAPPORTI PARENTELA,464,18720,19184
1,2023,Residenti,STATO FAMIGLIA E STATO CIVILE,454,15323,15777
1,2023,Residenti,STATO LIBERO,212,7726,7938
1,2023,Residenti,UNIONE CIVILE ,2,76,78
2,2023,AIRE,CITTADINANZA,0,183,183
2,2023,AIRE,CONTESTUALE,0,735,735
2,2023,AIRE,ESISTENZA IN VITA,0,2,2
2,2023,AIRE,MATRIMONIO,0,232,232
2,2023,AIRE,NASCITA,0,597,597
2,2023,AIRE,RESIDENZA,0,758,758
2,2023,AIRE,STATO CIVILE,0,21,21
2,2023,AIRE,STATO FAMIGLIA,0,410,410
2,2023,AIRE,STATO FAMIGLIA CON RAPPORTI PARENTELA,0,11,11
2,2023,AIRE,STATO FAMIGLIA E STATO CIVILE,0,11,11
2,2023,AIRE,STATO LIBERO,0,11,11
2,2023,AIRE,UNIONE CIVILE ,0,6,6
2,2023,Residenti,CITTADINANZA,0,2964,2964
2,2023,Residenti,CONTESTUALE,0,86272,86272
2,2023,Residenti,CONTRATTO CONVIVENZA,0,18,18
2,2023,Residenti,ESISTENZA IN VITA,0,2289,2289
2,2023,Residenti,MATRIMONIO,0,18142,18142
2,2023,Residenti,NASCITA,0,19863,19863
2,2023,Residenti,RESIDENZA,0,87956,87956
2,2023,Residenti,RESIDENZA IN CONVIVENZA,0,106,106
2,2023,Residenti,STATO CIVILE,0,17822,17822
2,2023,Residenti,STATO FAMIGLIA,0,88452,88452
2,2023,Residenti,STATO FAMIGLIA CON RAPPORTI PARENTELA,0,14602,14602
2,2023,Residenti,STATO FAMIGLIA E STATO CIVILE,0,12999,12999
2,2023,Residenti,STATO LIBERO,0,8339,8339
2,2023,Residenti,UNIONE CIVILE ,0,79,79
3,2023,AIRE,CITTADINANZA,0,185,185
3,2023,AIRE,CONTESTUALE,0,764,764
3,2023,AIRE,ESISTENZA IN VITA,0,6,6
3,2023,AIRE,MATRIMONIO,0,284,284
3,2023,AIRE,NASCITA,0,562,562
3,2023,AIRE,RESIDENZA,0,899,899
3,2023,AIRE,STATO CIVILE,0,21,21
3,2023,AIRE,STATO FAMIGLIA,0,391,391
3,2023,AIRE,STATO FAMIGLIA CON RAPPORTI PARENTELA,0,15,15
3,2023,AIRE,STATO FAMIGLIA E STATO CIVILE,0,8,8
3,2023,AIRE,STATO LIBERO,0,8,8
3,2023,AIRE,UNIONE CIVILE ,0,2,2
3,2023,Residenti,CITTADINANZA,0,2958,2958
3,2023,Residenti,CONTESTUALE,0,85775,85775
3,2023,Residenti,CONTRATTO CONVIVENZA,0,23,23
3,2023,Residenti,ESISTENZA IN VITA,0,2345,2345
3,2023,Residenti,MATRIMONIO,0,17010,17010
3,2023,Residenti,NASCITA,0,19909,19909
3,2023,Residenti,RESIDENZA,0,88603,88603
3,2023,Residenti,RESIDENZA IN CONVIVENZA,0,101,101
3,2023,Residenti,STATO CIVILE,0,17292,17292
3,2023,Residenti,STATO FAMIGLIA,0,78017,78017
3,2023,Residenti,STATO FAMIGLIA CON RAPPORTI PARENTELA,0,13181,13181
3,2023,Residenti,STATO FAMIGLIA E STATO CIVILE,0,11773,11773
3,2023,Residenti,STATO LIBERO,0,7664,7664
3,2023,Residenti,UNIONE CIVILE ,0,81,81
4,2023,AIRE,CITTADINANZA,0,158,158
4,2023,AIRE,CONTESTUALE,0,623,623
4,2023,AIRE,ESISTENZA IN VITA,0,4,4
4,2023,AIRE,MATRIMONIO,0,190,190
4,2023,AIRE,NASCITA,0,445,445
4,2023,AIRE,RESIDENZA,0,702,702
4,2023,AIRE,STATO CIVILE,0,15,15
4,2023,AIRE,STATO FAMIGLIA,0,328,328
4,2023,AIRE,STATO FAMIGLIA CON RAPPORTI PARENTELA,0,5,5
4,2023,AIRE,STATO FAMIGLIA E STATO CIVILE,0,5,5
4,2023,AIRE,STATO LIBERO,0,7,7
4,2023,AIRE,UNIONE CIVILE ,0,3,3
4,2023,Residenti,CITTADINANZA,0,2345,2345
4,2023,Residenti,CONTESTUALE,0,63641,63641
4,2023,Residenti,CONTRATTO CONVIVENZA,0,13,13
4,2023,Residenti,ESISTENZA IN VITA,0,1630,1630
4,2023,Residenti,MATRIMONIO,0,11894,11894
4,2023,Residenti,NASCITA,0,14549,14549
4,2023,Residenti,RESIDENZA,0,69106,69106
4,2023,Residenti,RESIDENZA IN CONVIVENZA,0,88,88
4,2023,Residenti,STATO CIVILE,0,12492,12492
4,2023,Residenti,STATO FAMIGLIA,0,54548,54548
4,2023,Residenti,STATO FAMIGLIA CON RAPPORTI PARENTELA,0,9431,9431
4,2023,Residenti,STATO FAMIGLIA E STATO CIVILE,0,8594,8594
4,2023,Residenti,STATO LIBERO,0,5508,5508
4,2023,Residenti,UNIONE CIVILE ,0,63,63
5,2023,AIRE,CITTADINANZA,0,139,139
5,2023,AIRE,CONTESTUALE,0,619,619
5,2023,AIRE,ESISTENZA IN VITA,0,4,4
5,2023,AIRE,MATRIMONIO,0,240,240
5,2023,AIRE,NASCITA,0,450,450
5,2023,AIRE,RESIDENZA,0,792,792
5,2023,AIRE,STATO CIVILE,0,17,17
5,2023,AIRE,STATO FAMIGLIA,0,381,381
5,2023,AIRE,STATO FAMIGLIA CON RAPPORTI PARENTELA,0,8,8
5,2023,AIRE,STATO FAMIGLIA E STATO CIVILE,0,11,11
5,2023,AIRE,STATO LIBERO,0,8,8
5,2023,AIRE,UNIONE CIVILE ,0,4,4
5,2023,Residenti,CITTADINANZA,0,2759,2759
5,2023,Residenti,CONTESTUALE,0,78353,78353
5,2023,Residenti,CONTRATTO CONVIVENZA,0,14,14
5,2023,Residenti,ESISTENZA IN VITA,0,1961,1961
5,2023,Residenti,MATRIMONIO,0,16014,16014
5,2023,Residenti,NASCITA,0,17406,17406
5,2023,Residenti,RESIDENZA,0,84770,84770
5,2023,Residenti,RESIDENZA IN CONVIVENZA,0,118,118
5,2023,Residenti,STATO CIVILE,0,15952,15952
5,2023,Residenti,STATO FAMIGLIA,0,66047,66047
5,2023,Residenti,STATO FAMIGLIA CON RAPPORTI PARENTELA,0,11096,11096
5,2023,Residenti,STATO FAMIGLIA E STATO CIVILE,0,10381,10381
5,2023,Residenti,STATO LIBERO,0,6481,6481
5,2023,Residenti,UNIONE CIVILE ,0,95,95
6,2023,AIRE,CITTADINANZA,0,121,121
6,2023,AIRE,CONTESTUALE,0,591,591
6,2023,AIRE,ESISTENZA IN VITA,0,3,3
6,2023,AIRE,MATRIMONIO,0,182,182
6,2023,AIRE,NASCITA,0,466,466
6,2023,AIRE,RESIDENZA,0,759,759
6,2023,AIRE,STATO CIVILE,0,14,14
6,2023,AIRE,STATO FAMIGLIA,0,312,312
6,2023,AIRE,STATO FAMIGLIA CON RAPPORTI PARENTELA,0,4,4
6,2023,AIRE,STATO FAMIGLIA E STATO CIVILE,0,3,3
6,2023,AIRE,STATO LIBERO,0,6,6
6,2023,Residenti,CITTADINANZA,0,2487,2487
6,2023,Residenti,CONTESTUALE,0,67672,67672
6,2023,Residenti,CONTRATTO CONVIVENZA,0,11,11
6,2023,Residenti,ESISTENZA IN VITA,0,2084,2084
6,2023,Residenti,MATRIMONIO,0,14687,14687
6,2023,Residenti,NASCITA,0,15892,15892
6,2023,Residenti,RESIDENZA,0,75611,75611
6,2023,Residenti,RESIDENZA IN CONVIVENZA,0,85,85
6,2023,Residenti,STATO CIVILE,0,13714,13714
6,2023,Residenti,STATO FAMIGLIA,0,60009,60009
6,2023,Residenti,STATO FAMIGLIA CON RAPPORTI PARENTELA,0,10311,10311
6,2023,Residenti,STATO FAMIGLIA E STATO CIVILE,0,9039,9039
6,2023,Residenti,STATO LIBERO,0,5756,5756
6,2023,Residenti,UNIONE CIVILE ,0,70,70
7,2023,AIRE,CITTADINANZA,0,151,151
7,2023,AIRE,CONTESTUALE,0,608,608
7,2023,AIRE,ESISTENZA IN VITA,0,3,3
7,2023,AIRE,MATRIMONIO,0,198,198
7,2023,AIRE,NASCITA,0,481,481
7,2023,AIRE,RESIDENZA,0,652,652
7,2023,AIRE,STATO CIVILE,0,16,16
7,2023,AIRE,STATO FAMIGLIA,0,306,306
7,2023,AIRE,STATO FAMIGLIA CON RAPPORTI PARENTELA,0,6,6
7,2023,AIRE,STATO FAMIGLIA E STATO CIVILE,0,4,4
7,2023,AIRE,STATO LIBERO,0,7,7
7,2023,AIRE,UNIONE CIVILE ,0,6,6
7,2023,Residenti,CITTADINANZA,0,2206,2206
7,2023,Residenti,CONTESTUALE,0,83874,83874
7,2023,Residenti,CONTRATTO CONVIVENZA,0,16,16
7,2023,Residenti,ESISTENZA IN VITA,0,1835,1835
7,2023,Residenti,MATRIMONIO,0,14339,14339
7,2023,Residenti,NASCITA,0,16027,16027
7,2023,Residenti,RESIDENZA,0,73494,73494
7,2023,Residenti,RESIDENZA IN CONVIVENZA,0,90,90
7,2023,Residenti,STATO CIVILE,0,12780,12780
7,2023,Residenti,STATO FAMIGLIA,0,64379,64379
7,2023,Residenti,STATO FAMIGLIA CON RAPPORTI PARENTELA,0,10556,10556
7,2023,Residenti,STATO FAMIGLIA E STATO CIVILE,0,8320,8320
7,2023,Residenti,STATO LIBERO,0,5157,5157
7,2023,Residenti,UNIONE CIVILE ,0,97,97
8,2023,AIRE,CITTADINANZA,9,86,95
8,2023,AIRE,CONTESTUALE,61,378,439
8,2023,AIRE,MATRIMONIO,23,140,163
8,2023,AIRE,NASCITA,98,331,429
8,2023,AIRE,RESIDENZA,100,473,573
8,2023,AIRE,STATO CIVILE,2,11,13
8,2023,AIRE,STATO FAMIGLIA,22,206,228
8,2023,AIRE,STATO FAMIGLIA CON RAPPORTI PARENTELA,1,2,3
8,2023,AIRE,STATO FAMIGLIA E STATO CIVILE,0,1,1
8,2023,AIRE,STATO LIBERO,2,1,3
8,2023,AIRE,UNIONE CIVILE ,1,1,2
8,2023,Residenti,CITTADINANZA,69,1775,1844
8,2023,Residenti,CONTESTUALE,5211,61066,66277
8,2023,Residenti,CONTRATTO CONVIVENZA,3,13,16
8,2023,Residenti,ESISTENZA IN VITA,90,1037,1127
8,2023,Residenti,MATRIMONIO,744,7646,8390
8,2023,Residenti,NASCITA,1163,11388,12551
8,2023,Residenti,RESIDENZA,3282,52784,56066
8,2023,Residenti,RESIDENZA IN CONVIVENZA,1,57,58
8,2023,Residenti,STATO CIVILE,692,6593,7285
8,2023,Residenti,STATO FAMIGLIA,3374,43475,46849
8,2023,Residenti,STATO FAMIGLIA CON RAPPORTI PARENTELA,503,7213,7716
8,2023,Residenti,STATO FAMIGLIA E STATO CIVILE,417,5588,6005
8,2023,Residenti,STATO LIBERO,768,2115,2883
8,2023,Residenti,UNIONE CIVILE ,10,49,59
9,2023,AIRE,CITTADINANZA,11,104,115
9,2023,AIRE,CONTESTUALE,91,434,525
9,2023,AIRE,ESISTENZA IN VITA,0,1,1
9,2023,AIRE,MATRIMONIO,30,184,214
9,2023,AIRE,NASCITA,134,280,414
9,2023,AIRE,RESIDENZA,123,516,639
9,2023,AIRE,STATO CIVILE,1,9,10
9,2023,AIRE,STATO FAMIGLIA,38,245,283
9,2023,AIRE,STATO FAMIGLIA CON RAPPORTI PARENTELA,0,8,8
9,2023,AIRE,STATO FAMIGLIA E STATO CIVILE,0,8,8
9,2023,AIRE,STATO LIBERO,4,7,11
9,2023,AIRE,UNIONE CIVILE ,1,0,1
9,2023,Residenti,CITTADINANZA,104,2186,2290
9,2023,Residenti,CONTESTUALE,9130,133643,142773
9,2023,Residenti,CONTRATTO CONVIVENZA,1,9,10
9,2023,Residenti,ESISTENZA IN VITA,148,1533,1681
9,2023,Residenti,MATRIMONIO,1602,13137,14739
9,2023,Residenti,NASCITA,1648,17427,19075
9,2023,Residenti,RESIDENZA,5169,73855,79024
9,2023,Residenti,RESIDENZA IN CONVIVENZA,2,76,78
9,2023,Residenti,STATO CIVILE,2008,12172,14180
9,2023,Residenti,STATO FAMIGLIA,5684,73291,78975
9,2023,Residenti,STATO FAMIGLIA CON RAPPORTI PARENTELA,721,10999,11720
9,2023,Residenti,STATO FAMIGLIA E STATO CIVILE,789,9028,9817
9,2023,Residenti,STATO LIBERO,1924,4389,6313
9,2023,Residenti,UNIONE CIVILE ,13,76,89
10,2023,AIRE,CITTADINANZA,6,105,111
10,2023,AIRE,CONTESTUALE,111,469,580
10,2023,AIRE,ESISTENZA IN VITA,0,3,3
10,2023,AIRE,MATRIMONIO,24,185,209
10,2023,AIRE,NASCITA,98,366,464
10,2023,AIRE,RESIDENZA,124,667,791
10,2023,AIRE,STATO CIVILE,2,11,13
10,2023,AIRE,STATO FAMIGLIA,36,258,294
10,2023,AIRE,STATO FAMIGLIA CON RAPPORTI PARENTELA,0,6,6
10,2023,AIRE,STATO FAMIGLIA E STATO CIVILE,0,4,4
10,2023,AIRE,STATO LIBERO,3,2,5
10,2023,AIRE,UNIONE CIVILE ,0,1,1
10,2023,Residenti,CITTADINANZA,127,2352,2479
10,2023,Residenti,CONTESTUALE,10175,103245,113420
10,2023,Residenti,CONTRATTO CONVIVENZA,3,16,19
10,2023,Residenti,ESISTENZA IN VITA,181,1815,1996
10,2023,Residenti,MATRIMONIO,1659,14723,16382
10,2023,Residenti,NASCITA,1522,16874,18396
10,2023,Residenti,RESIDENZA,5589,76244,81833
10,2023,Residenti,RESIDENZA IN CONVIVENZA,5,95,100
10,2023,Residenti,STATO CIVILE,2150,12691,14841
10,2023,Residenti,STATO FAMIGLIA,5661,68758,74419
10,2023,Residenti,STATO FAMIGLIA CON RAPPORTI PARENTELA,774,10954,11728
10,2023,Residenti,STATO FAMIGLIA E STATO CIVILE,905,9521,10426
10,2023,Residenti,STATO LIBERO,2132,4553,6685
10,2023,Residenti,UNIONE CIVILE ,9,73,82
11,2023,AIRE,CITTADINANZA,7,112,119
11,2023,AIRE,CONTESTUALE,102,462,564
11,2023,AIRE,MATRIMONIO,21,171,192
11,2023,AIRE,NASCITA,136,317,453
11,2023,AIRE,RESIDENZA,125,604,729
11,2023,AIRE,STATO CIVILE,3,6,9
11,2023,AIRE,STATO FAMIGLIA,28,245,273
11,2023,AIRE,STATO FAMIGLIA CON RAPPORTI PARENTELA,0,6,6
11,2023,AIRE,STATO FAMIGLIA E STATO CIVILE,1,0,1
11,2023,AIRE,STATO LIBERO,1,4,5
11,2023,Residenti,CITTADINANZA,92,1961,2053
11,2023,Residenti,CONTESTUALE,9612,69667,79279
11,2023,Residenti,CONTRATTO CONVIVENZA,1,10,11
11,2023,Residenti,ESISTENZA IN VITA,177,1817,1994
11,2023,Residenti,MATRIMONIO,1390,13325,14715
11,2023,Residenti,NASCITA,1436,14161,15597
11,2023,Residenti,RESIDENZA,4963,70254,75217
11,2023,Residenti,RESIDENZA IN CONVIVENZA,1,66,67
11,2023,Residenti,STATO CIVILE,2107,11999,14106
11,2023,Residenti,STATO FAMIGLIA,5480,60643,66123
11,2023,Residenti,STATO FAMIGLIA CON RAPPORTI PARENTELA,771,10652,11423
11,2023,Residenti,STATO FAMIGLIA E STATO CIVILE,817,8707,9524
11,2023,Residenti,STATO LIBERO,2406,4896,7302
11,2023,Residenti,UNIONE CIVILE ,21,69,90
12,2023,AIRE,CITTADINANZA,14,91,105
12,2023,AIRE,CONTESTUALE,110,455,565
12,2023,AIRE,ESISTENZA IN VITA,0,2,2
12,2023,AIRE,MATRIMONIO,25,155,180
12,2023,AIRE,NASCITA,106,296,402
12,2023,AIRE,RESIDENZA,88,615,703
12,2023,AIRE,STATO CIVILE,2,9,11
12,2023,AIRE,STATO FAMIGLIA,26,224,250
12,2023,AIRE,STATO FAMIGLIA CON RAPPORTI PARENTELA,0,8,8
12,2023,AIRE,STATO FAMIGLIA E STATO CIVILE,0,4,4
12,2023,AIRE,STATO LIBERO,2,3,5
12,2023,AIRE,UNIONE CIVILE ,1,0,1
12,2023,Residenti,CITTADINANZA,97,1832,1929
12,2023,Residenti,CONTESTUALE,7667,60111,67778
12,2023,Residenti,CONTRATTO CONVIVENZA,2,10,12
12,2023,Residenti,ESISTENZA IN VITA,166,2268,2434
12,2023,Residenti,MATRIMONIO,996,10982,11978
12,2023,Residenti,NASCITA,1243,12129,13372
12,2023,Residenti,RESIDENZA,4305,125716,130021
12,2023,Residenti,RESIDENZA IN CONVIVENZA,1,68,69
12,2023,Residenti,STATO CIVILE,1615,10021,11636
12,2023,Residenti,STATO FAMIGLIA,4537,50156,54693
12,2023,Residenti,STATO FAMIGLIA CON RAPPORTI PARENTELA,715,8130,8845
12,2023,Residenti,STATO FAMIGLIA E STATO CIVILE,647,6562,7209
12,2023,Residenti,STATO LIBERO,1699,3720,5419
12,2023,Residenti,UNIONE CIVILE ,8,52,60
1,2024,AIRE,CITTADINANZA,15,101,116
1,2024,AIRE,CONTESTUALE,123,569,692
1,2024,AIRE,MATRIMONIO,32,183,215
1,2024,AIRE,NASCITA,187,369,556
1,2024,AIRE,RESIDENZA,146,900,1046
1,2024,AIRE,STATO CIVILE,3,10,13
1,2024,AIRE,STATO FAMIGLIA,33,289,322
1,2024,AIRE,STATO FAMIGLIA CON RAPPORTI PARENTELA,1,6,7
1,2024,AIRE,STATO FAMIGLIA E STATO CIVILE,0,3,3
1,2024,AIRE,STATO LIBERO,4,12,16
1,2024,AIRE,UNIONE CIVILE ,0,2,2
1,2024,Residenti,CITTADINANZA,137,2730,2867
1,2024,Residenti,CONTESTUALE,11914,109175,121089
1,2024,Residenti,CONTRATTO CONVIVENZA,1,23,24
1,2024,Residenti,ESISTENZA IN VITA,211,4536,4747
1,2024,Residenti,MATRIMONIO,1366,17051,18417
1,2024,Residenti,NASCITA,1841,19408,21249
1,2024,Residenti,RESIDENZA,6058,245177,251235
1,2024,Residenti,RESIDENZA IN CONVIVENZA,0,172,172
1,2024,Residenti,STATO CIVILE,2073,16079,18152
1,2024,Residenti,STATO FAMIGLIA,7781,110359,118140
1,2024,Residenti,STATO FAMIGLIA CON RAPPORTI PARENTELA,1118,14380,15498
1,2024,Residenti,STATO FAMIGLIA E STATO CIVILE,1009,11885,12894
1,2024,Residenti,STATO LIBERO,2250,5134,7384
1,2024,Residenti,UNIONE CIVILE ,11,81,92
2,2024,AIRE,CITTADINANZA,13,145,158
2,2024,AIRE,CONTESTUALE,138,510,648
2,2024,AIRE,ESISTENZA IN VITA,0,2,2
2,2024,AIRE,MATRIMONIO,32,168,200
2,2024,AIRE,NASCITA,185,419,604
2,2024,AIRE,RESIDENZA,140,1051,1191
2,2024,AIRE,STATO CIVILE,4,18,22
2,2024,AIRE,STATO FAMIGLIA,23,301,324
2,2024,AIRE,STATO FAMIGLIA CON RAPPORTI PARENTELA,1,10,11
2,2024,AIRE,STATO FAMIGLIA E STATO CIVILE,0,8,8
2,2024,AIRE,STATO LIBERO,2,6,8
2,2024,AIRE,UNIONE CIVILE ,1,2,3
2,2024,Residenti,CITTADINANZA,121,2779,2900
2,2024,Residenti,CONTESTUALE,13361,118359,131720
2,2024,Residenti,CONTRATTO CONVIVENZA,3,20,23
2,2024,Residenti,ESISTENZA IN VITA,181,3888,4069
2,2024,Residenti,MATRIMONIO,1277,18835,20112
2,2024,Residenti,NASCITA,1750,19835,21585
2,2024,Residenti,RESIDENZA,5833,270570,276403
2,2024,Residenti,RESIDENZA IN CONVIVENZA,4,212,216
2,2024,Residenti,STATO CIVILE,2150,17127,19277
2,2024,Residenti,STATO FAMIGLIA,7079,92614,99693
2,2024,Residenti,STATO FAMIGLIA CON RAPPORTI PARENTELA,861,11631,12492
2,2024,Residenti,STATO FAMIGLIA E STATO CIVILE,1039,10541,11580
2,2024,Residenti,STATO LIBERO,2396,5529,7925
2,2024,Residenti,UNIONE CIVILE ,10,90,100
3,2024,AIRE,CITTADINANZA,9,112,121
3,2024,AIRE,CONTESTUALE,145,614,759
3,2024,AIRE,ESISTENZA IN VITA,0,1,1
3,2024,AIRE,GODIMENTO DEI DIRITTI POLITICI,0,9,9
3,2024,AIRE,ISCRIZIONE NELLE LISTE ELETTORALI,2,13,15
3,2024,AIRE,MATRIMONIO,23,198,221
3,2024,AIRE,NASCITA,182,460,642
3,2024,AIRE,RESIDENZA,163,1144,1307
3,2024,AIRE,STATO CIVILE,4,14,18
3,2024,AIRE,STATO FAMIGLIA,27,298,325
3,2024,AIRE,STATO FAMIGLIA CON RAPPORTI PARENTELA,1,3,4
3,2024,AIRE,STATO FAMIGLIA E STATO CIVILE,1,11,12
3,2024,AIRE,STATO LIBERO,5,7,12
3,2024,AIRE,UNIONE CIVILE ,1,5,6
3,2024,Residenti,CITTADINANZA,163,2820,2983
3,2024,Residenti,CONTESTUALE,17102,124852,141954
3,2024,Residenti,CONTRATTO CONVIVENZA,4,16,20
3,2024,Residenti,ESISTENZA IN VITA,182,3352,3534
3,2024,Residenti,GODIMENTO DEI DIRITTI POLITICI,53,281,334
3,2024,Residenti,ISCRIZIONE NELLE LISTE ELETTORALI,15,800,815
3,2024,Residenti,MATRIMONIO,1351,18002,19353
3,2024,Residenti,NASCITA,1710,19330,21040
3,2024,Residenti,RESIDENZA,6090,268403,274493
3,2024,Residenti,RESIDENZA IN CONVIVENZA,4,223,227
3,2024,Residenti,STATO CIVILE,2134,16834,18968
3,2024,Residenti,STATO FAMIGLIA,6719,84543,91262
3,2024,Residenti,STATO FAMIGLIA CON RAPPORTI PARENTELA,860,10383,11243
3,2024,Residenti,STATO FAMIGLIA E STATO CIVILE,989,9529,10518
3,2024,Residenti,STATO LIBERO,2453,5509,7962
3,2024,Residenti,UNIONE CIVILE ,7,90,97
4,2024,AIRE,CITTADINANZA,18,135,153
4,2024,AIRE,CONTESTUALE,151,617,768
4,2024,AIRE,ESISTENZA IN VITA,0,2,2
4,2024,AIRE,GODIMENTO DEI DIRITTI POLITICI,2,10,12
4,2024,AIRE,ISCRIZIONE NELLE LISTE ELETTORALI,3,16,19
4,2024,AIRE,MATRIMONIO,30,171,201
4,2024,AIRE,NASCITA,156,430,586
4,2024,AIRE,RESIDENZA,198,1117,1315
4,2024,AIRE,STATO CIVILE,5,9,14
4,2024,AIRE,STATO FAMIGLIA,42,280,322
4,2024,AIRE,STATO FAMIGLIA CON RAPPORTI PARENTELA,0,6,6
4,2024,AIRE,STATO FAMIGLIA E STATO CIVILE,0,14,14
4,2024,AIRE,STATO LIBERO,1,4,5
4,2024,AIRE,UNIONE CIVILE ,1,0,1
4,2024,Residenti,CITTADINANZA,118,2803,2921
4,2024,Residenti,CONTESTUALE,13868,117423,131291
4,2024,Residenti,CONTRATTO CONVIVENZA,3,16,19
4,2024,Residenti,ESISTENZA IN VITA,170,3140,3310
4,2024,Residenti,GODIMENTO DEI DIRITTI POLITICI,66,785,851
4,2024,Residenti,ISCRIZIONE NELLE LISTE ELETTORALI,110,7679,7789
4,2024,Residenti,MATRIMONIO,1310,17758,19068
4,2024,Residenti,NASCITA,1812,18593,20405
4,2024,Residenti,RESIDENZA,5750,258653,264403
4,2024,Residenti,RESIDENZA IN CONVIVENZA,2,210,212
4,2024,Residenti,STATO CIVILE,2179,16398,18577
4,2024,Residenti,STATO FAMIGLIA,6337,79238,85575
4,2024,Residenti,STATO FAMIGLIA CON RAPPORTI PARENTELA,814,9544,10358
4,2024,Residenti,STATO FAMIGLIA E STATO CIVILE,937,9146,10083
4,2024,Residenti,STATO LIBERO,2564,5450,8014
4,2024,Residenti,UNIONE CIVILE ,15,78,93
5,2024,AIRE,CITTADINANZA,17,113,130
5,2024,AIRE,CONTESTUALE,135,684,819
5,2024,AIRE,ESISTENZA IN VITA,0,3,3
5,2024,AIRE,GODIMENTO DEI DIRITTI POLITICI,1,9,10
5,2024,AIRE,ISCRIZIONE NELLE LISTE ELETTORALI,4,57,61
5,2024,AIRE,MATRIMONIO,29,213,242
5,2024,AIRE,NASCITA,149,386,535
5,2024,AIRE,RESIDENZA,162,1131,1293
5,2024,AIRE,STATO CIVILE,5,21,26
5,2024,AIRE,STATO FAMIGLIA,47,297,344
5,2024,AIRE,STATO FAMIGLIA CON RAPPORTI PARENTELA,0,2,2
5,2024,AIRE,STATO FAMIGLIA E STATO CIVILE,1,3,4
5,2024,AIRE,STATO LIBERO,1,3,4
5,2024,AIRE,UNIONE CIVILE ,2,5,7
5,2024,Residenti,CITTADINANZA,120,3185,3305
5,2024,Residenti,CONTESTUALE,14825,134263,149088
5,2024,Residenti,CONTRATTO CONVIVENZA,4,21,25
5,2024,Residenti,ESISTENZA IN VITA,194,3582,3776
5,2024,Residenti,GODIMENTO DEI DIRITTI POLITICI,101,1183,1284
5,2024,Residenti,ISCRIZIONE NELLE LISTE ELETTORALI,95,7998,8093
5,2024,Residenti,MATRIMONIO,1744,20568,22312
5,2024,Residenti,NASCITA,1831,21907,23738
5,2024,Residenti,RESIDENZA,6094,297247,303341
5,2024,Residenti,RESIDENZA IN CONVIVENZA,4,174,178
5,2024,Residenti,STATO CIVILE,2701,19604,22305
5,2024,Residenti,STATO FAMIGLIA,7246,90489,97735
5,2024,Residenti,STATO FAMIGLIA CON RAPPORTI PARENTELA,969,11064,12033
5,2024,Residenti,STATO FAMIGLIA E STATO CIVILE,1099,9916,11015
5,2024,Residenti,STATO LIBERO,2891,6634,9525
5,2024,Residenti,UNIONE CIVILE ,13,87,100
6,2024,AIRE,CITTADINANZA,13,106,119
6,2024,AIRE,CONTESTUALE,124,637,761
6,2024,AIRE,ESISTENZA IN VITA,0,6,6
6,2024,AIRE,GODIMENTO DEI DIRITTI POLITICI,0,5,5
6,2024,AIRE,ISCRIZIONE NELLE LISTE ELETTORALI,2,70,72
6,2024,AIRE,MATRIMONIO,43,178,221
6,2024,AIRE,NASCITA,174,355,529
6,2024,AIRE,RESIDENZA,169,927,1096
6,2024,AIRE,STATO CIVILE,2,11,13
6,2024,AIRE,STATO FAMIGLIA,45,310,355
6,2024,AIRE,STATO FAMIGLIA CON RAPPORTI PARENTELA,1,6,7
6,2024,AIRE,STATO FAMIGLIA E STATO CIVILE,1,5,6
6,2024,AIRE,STATO LIBERO,2,3,5
6,2024,AIRE,UNIONE CIVILE ,0,3,3
6,2024,Residenti,CITTADINANZA,136,2701,2837
6,2024,Residenti,CONTESTUALE,11539,117573,129112
6,2024,Residenti,CONTRATTO CONVIVENZA,1,20,21
6,2024,Residenti,ESISTENZA IN VITA,172,3300,3472
6,2024,Residenti,GODIMENTO DEI DIRITTI POLITICI,95,1145,1240
6,2024,Residenti,ISCRIZIONE NELLE LISTE ELETTORALI,27,2017,2044
6,2024,Residenti,MATRIMONIO,1785,18131,19916
6,2024,Residenti,NASCITA,1682,17363,19045
6,2024,Residenti,RESIDENZA,5447,262537,267984
6,2024,Residenti,RESIDENZA IN CONVIVENZA,1,163,164
6,2024,Residenti,STATO CIVILE,2315,17580,19895
6,2024,Residenti,STATO FAMIGLIA,6588,78729,85317
6,2024,Residenti,STATO FAMIGLIA CON RAPPORTI PARENTELA,839,9250,10089
6,2024,Residenti,STATO FAMIGLIA E STATO CIVILE,979,8506,9485
6,2024,Residenti,STATO LIBERO,2443,5778,8221
6,2024,Residenti,UNIONE CIVILE ,19,79,98
7,2024,AIRE,CITTADINANZA,13,124,137
7,2024,AIRE,CONTESTUALE,112,588,700
7,2024,AIRE,ESISTENZA IN VITA,0,2,2
7,2024,AIRE,GODIMENTO DEI DIRITTI POLITICI,1,6,7
7,2024,AIRE,ISCRIZIONE NELLE LISTE ELETTORALI,0,7,7
7,2024,AIRE,MATRIMONIO,40,166,206
7,2024,AIRE,NASCITA,186,353,539
7,2024,AIRE,RESIDENZA,187,1065,1252
7,2024,AIRE,STATO CIVILE,9,10,19
7,2024,AIRE,STATO FAMIGLIA,51,322,373
7,2024,AIRE,STATO FAMIGLIA CON RAPPORTI PARENTELA,1,2,3
7,2024,AIRE,STATO FAMIGLIA E STATO CIVILE,0,1,1
7,2024,AIRE,STATO LIBERO,0,6,6
7,2024,AIRE,UNIONE CIVILE ,0,1,1
7,2024,Residenti,CITTADINANZA,142,2927,3069
7,2024,Residenti,CONTESTUALE,12096,151218,163314
7,2024,Residenti,CONTRATTO CONVIVENZA,3,23,26
7,2024,Residenti,ESISTENZA IN VITA,169,3623,3792
7,2024,Residenti,GODIMENTO DEI DIRITTI POLITICI,118,243,361
7,2024,Residenti,ISCRIZIONE NELLE LISTE ELETTORALI,24,211,235
7,2024,Residenti,MATRIMONIO,1887,19847,21734
7,2024,Residenti,NASCITA,1816,19102,20918
7,2024,Residenti,RESIDENZA,6206,286864,293070
7,2024,Residenti,RESIDENZA IN CONVIVENZA,5,186,191
7,2024,Residenti,STATO CIVILE,2371,18416,20787
7,2024,Residenti,STATO FAMIGLIA,7052,88665,95717
7,2024,Residenti,STATO FAMIGLIA CON RAPPORTI PARENTELA,989,10304,11293
7,2024,Residenti,STATO FAMIGLIA E STATO CIVILE,1084,8995,10079
7,2024,Residenti,STATO LIBERO,2571,5938,8509
7,2024,Residenti,UNIONE CIVILE ,23,77,100
8,2024,AIRE,CITTADINANZA,29,92,121
8,2024,AIRE,CONTESTUALE,93,431,524
8,2024,AIRE,GODIMENTO DEI DIRITTI POLITICI,1,5,6
8,2024,AIRE,ISCRIZIONE NELLE LISTE ELETTORALI,0,5,5
8,2024,AIRE,MATRIMONIO,24,162,186
8,2024,AIRE,NASCITA,180,356,536
8,2024,AIRE,RESIDENZA,127,720,847
8,2024,AIRE,STATO CIVILE,1,9,10
8,2024,AIRE,STATO FAMIGLIA,41,230,271
8,2024,AIRE,STATO FAMIGLIA E STATO CIVILE,0,2,2
8,2024,AIRE,STATO LIBERO,1,2,3
8,2024,AIRE,UNIONE CIVILE ,1,1,2
8,2024,Residenti,CITTADINANZA,113,2054,2167
8,2024,Residenti,CONTESTUALE,6952,83196,90148
8,2024,Residenti,CONTRATTO CONVIVENZA,2,15,17
8,2024,Residenti,ESISTENZA IN VITA,101,1723,1824
8,2024,Residenti,GODIMENTO DEI DIRITTI POLITICI,56,166,222
8,2024,Residenti,ISCRIZIONE NELLE LISTE ELETTORALI,22,299,321
8,2024,Residenti,MATRIMONIO,929,9354,10283
8,2024,Residenti,NASCITA,1453,12727,14180
8,2024,Residenti,RESIDENZA,4392,134675,139067
8,2024,Residenti,RESIDENZA IN CONVIVENZA,2,84,86
8,2024,Residenti,STATO CIVILE,864,8470,9334
8,2024,Residenti,STATO FAMIGLIA,4255,52976,57231
8,2024,Residenti,STATO FAMIGLIA CON RAPPORTI PARENTELA,636,6845,7481
8,2024,Residenti,STATO FAMIGLIA E STATO CIVILE,559,5339,5898
8,2024,Residenti,STATO LIBERO,942,2295,3237
8,2024,Residenti,UNIONE CIVILE ,9,55,64
9,2024,AIRE,CITTADINANZA,16,127,143
9,2024,AIRE,CONTESTUALE,133,596,729
9,2024,AIRE,ESISTENZA IN VITA,0,1,1
9,2024,AIRE,GODIMENTO DEI DIRITTI POLITICI,1,1,2
9,2024,AIRE,ISCRIZIONE NELLE LISTE ELETTORALI,1,11,12
9,2024,AIRE,MATRIMONIO,53,213,266
9,2024,AIRE,NASCITA,182,448,630
9,2024,AIRE,RESIDENZA,167,1017,1184
9,2024,AIRE,STATO CIVILE,2,14,16
9,2024,AIRE,STATO FAMIGLIA,44,318,362
9,2024,AIRE,STATO FAMIGLIA CON RAPPORTI PARENTELA,0,4,4
9,2024,AIRE,STATO FAMIGLIA E STATO CIVILE,0,5,5
9,2024,AIRE,STATO LIBERO,4,4,8
9,2024,AIRE,UNIONE CIVILE ,3,0,3
9,2024,Residenti,CITTADINANZA,150,3366,3516
9,2024,Residenti,CONTESTUALE,13060,203351,216411
9,2024,Residenti,CONTRATTO CONVIVENZA,5,20,25
9,2024,Residenti,ESISTENZA IN VITA,199,3430,3629
9,2024,Residenti,GODIMENTO DEI DIRITTI POLITICI,82,279,361
9,2024,Residenti,ISCRIZIONE NELLE LISTE ELETTORALI,15,335,350
9,2024,Residenti,MATRIMONIO,1932,19849,21781
9,2024,Residenti,NASCITA,1911,21809,23720
9,2024,Residenti,RESIDENZA,6335,293432,299767
9,2024,Residenti,RESIDENZA IN CONVIVENZA,3,217,220
9,2024,Residenti,STATO CIVILE,2553,18715,21268
9,2024,Residenti,STATO FAMIGLIA,7300,104361,111661
9,2024,Residenti,STATO FAMIGLIA CON RAPPORTI PARENTELA,953,11815,12768
9,2024,Residenti,STATO FAMIGLIA E STATO CIVILE,1014,9865,10879
9,2024,Residenti,STATO LIBERO,2629,6039,8668
9,2024,Residenti,UNIONE CIVILE ,20,93,113
10,2024,AIRE,CITTADINANZA,18,101,119
10,2024,AIRE,CONTESTUALE,143,659,802
10,2024,AIRE,ESISTENZA IN VITA,0,2,2
10,2024,AIRE,GODIMENTO DEI DIRITTI POLITICI,0,1,1
10,2024,AIRE,ISCRIZIONE NELLE LISTE ELETTORALI,0,6,6
10,2024,AIRE,MATRIMONIO,41,224,265
10,2024,AIRE,NASCITA,205,465,670
10,2024,AIRE,RESIDENZA,220,1273,1493
10,2024,AIRE,STATO CIVILE,8,9,17
10,2024,AIRE,STATO FAMIGLIA,40,337,377
10,2024,AIRE,STATO FAMIGLIA CON RAPPORTI PARENTELA,0,5,5
10,2024,AIRE,STATO FAMIGLIA E STATO CIVILE,0,2,2
10,2024,AIRE,STATO LIBERO,2,5,7
10,2024,AIRE,UNIONE CIVILE ,0,1,1
10,2024,Residenti,CITTADINANZA,169,3618,3787
10,2024,Residenti,CONTESTUALE,15394,190915,206309
10,2024,Residenti,CONTRATTO CONVIVENZA,0,23,23
10,2024,Residenti,ESISTENZA IN VITA,256,4050,4306
10,2024,Residenti,GODIMENTO DEI DIRITTI POLITICI,54,264,318
10,2024,Residenti,ISCRIZIONE NELLE LISTE ELETTORALI,16,657,673
10,2024,Residenti,MATRIMONIO,2284,23426,25710
10,2024,Residenti,NASCITA,1824,22446,24270
10,2024,Residenti,RESIDENZA,7439,335698,343137
10,2024,Residenti,RESIDENZA IN CONVIVENZA,5,229,234
10,2024,Residenti,STATO CIVILE,2857,21572,24429
10,2024,Residenti,STATO FAMIGLIA,8320,105142,113462
10,2024,Residenti,STATO FAMIGLIA CON RAPPORTI PARENTELA,1055,11967,13022
10,2024,Residenti,STATO FAMIGLIA E STATO CIVILE,1287,10685,11972
10,2024,Residenti,STATO LIBERO,3100,6743,9843
10,2024,Residenti,UNIONE CIVILE ,21,110,131
11,2024,AIRE,CITTADINANZA,28,102,130
11,2024,AIRE,CONTESTUALE,155,612,767
11,2024,AIRE,ESISTENZA IN VITA,0,2,2
11,2024,AIRE,GODIMENTO DEI DIRITTI POLITICI,0,8,8
11,2024,AIRE,ISCRIZIONE NELLE LISTE ELETTORALI,0,3,3
11,2024,AIRE,MATRIMONIO,54,212,266
11,2024,AIRE,NASCITA,207,452,659
11,2024,AIRE,RESIDENZA,157,1154,1311
11,2024,AIRE,STATO CIVILE,4,5,9
11,2024,AIRE,STATO FAMIGLIA,53,303,356
11,2024,AIRE,STATO FAMIGLIA CON RAPPORTI PARENTELA,0,5,5
11,2024,AIRE,STATO FAMIGLIA E STATO CIVILE,3,4,7
11,2024,AIRE,STATO LIBERO,0,7,7
11,2024,AIRE,UNIONE CIVILE ,1,2,3
11,2024,Residenti,CITTADINANZA,107,3167,3274
11,2024,Residenti,CONTESTUALE,12787,144214,157001
11,2024,Residenti,CONTRATTO CONVIVENZA,2,19,21
11,2024,Residenti,ESISTENZA IN VITA,188,3337,3525
11,2024,Residenti,GODIMENTO DEI DIRITTI POLITICI,118,225,343
11,2024,Residenti,ISCRIZIONE NELLE LISTE ELETTORALI,15,259,274
11,2024,Residenti,MATRIMONIO,1633,19647,21280
11,2024,Residenti,NASCITA,1606,18973,20579
11,2024,Residenti,RESIDENZA,6220,300836,307056
11,2024,Residenti,RESIDENZA IN CONVIVENZA,5,221,226
11,2024,Residenti,STATO CIVILE,2778,19037,21815
11,2024,Residenti,STATO FAMIGLIA,6528,89335,95863
11,2024,Residenti,STATO FAMIGLIA CON RAPPORTI PARENTELA,828,11129,11957
11,2024,Residenti,STATO FAMIGLIA E STATO CIVILE,1005,9345,10350
11,2024,Residenti,STATO LIBERO,3013,6507,9520
11,2024,Residenti,UNIONE CIVILE ,19,85,104
12,2024,AIRE,CITTADINANZA,16,126,142
12,2024,AIRE,CONTESTUALE,110,570,680
12,2024,AIRE,ESISTENZA IN VITA,0,2,2
12,2024,AIRE,GODIMENTO DEI DIRITTI POLITICI,2,5,7
12,2024,AIRE,ISCRIZIONE NELLE LISTE ELETTORALI,0,7,7
12,2024,AIRE,MATRIMONIO,38,187,225
12,2024,AIRE,NASCITA,173,372,545
12,2024,AIRE,RESIDENZA,165,1177,1342
12,2024,AIRE,STATO CIVILE,5,11,16
12,2024,AIRE,STATO FAMIGLIA,48,301,349
12,2024,AIRE,STATO FAMIGLIA CON RAPPORTI PARENTELA,0,2,2
12,2024,AIRE,STATO FAMIGLIA E STATO CIVILE,0,2,2
12,2024,AIRE,STATO LIBERO,1,0,1
12,2024,AIRE,UNIONE CIVILE ,1,0,1
12,2024,Residenti,CITTADINANZA,98,2875,2973
12,2024,Residenti,CONTESTUALE,9691,108686,118377
12,2024,Residenti,CONTRATTO CONVIVENZA,4,17,21
12,2024,Residenti,ESISTENZA IN VITA,168,2956,3124
12,2024,Residenti,GODIMENTO DEI DIRITTI POLITICI,67,180,247
12,2024,Residenti,ISCRIZIONE NELLE LISTE ELETTORALI,11,167,178
12,2024,Residenti,MATRIMONIO,1266,15345,16611
12,2024,Residenti,NASCITA,1507,15792,17299
12,2024,Residenti,RESIDENZA,5265,241611,246876
12,2024,Residenti,RESIDENZA IN CONVIVENZA,2,146,148
12,2024,Residenti,STATO CIVILE,2063,14479,16542
12,2024,Residenti,STATO FAMIGLIA,5616,69298,74914
12,2024,Residenti,STATO FAMIGLIA CON RAPPORTI PARENTELA,829,8688,9517
12,2024,Residenti,STATO FAMIGLIA E STATO CIVILE,846,7281,8127
12,2024,Residenti,STATO LIBERO,2202,4507,6709
12,2024,Residenti,UNIONE CIVILE ,9,71,80
1,2025,AIRE,CITTADINANZA,28,137,165
1,2025,AIRE,CONTESTUALE,172,665,837
1,2025,AIRE,ESISTENZA IN VITA,1,3,4
1,2025,AIRE,GODIMENTO DEI DIRITTI POLITICI,0,6,6
1,2025,AIRE,ISCRIZIONE NELLE LISTE ELETTORALI,2,9,11
1,2025,AIRE,MATRIMONIO,39,230,269
1,2025,AIRE,NASCITA,269,494,763
1,2025,AIRE,RESIDENZA,163,1299,1462
1,2025,AIRE,STATO CIVILE,4,15,19
1,2025,AIRE,STATO FAMIGLIA,61,351,412
1,2025,AIRE,STATO FAMIGLIA CON RAPPORTI PARENTELA,1,3,4
1,2025,AIRE,STATO FAMIGLIA E STATO CIVILE,6,8,14
1,2025,AIRE,STATO LIBERO,4,4,8
1,2025,AIRE,UNIONE CIVILE ,2,5,7
1,2025,Residenti,CITTADINANZA,161,3439,3600
1,2025,Residenti,CONTESTUALE,16358,159014,175372
1,2025,Residenti,CONTRATTO CONVIVENZA,7,33,40
1,2025,Residenti,ESISTENZA IN VITA,263,4479,4742
1,2025,Residenti,GODIMENTO DEI DIRITTI POLITICI,83,390,473
1,2025,Residenti,ISCRIZIONE NELLE LISTE ELETTORALI,11,295,306
1,2025,Residenti,MATRIMONIO,1810,20348,22158
1,2025,Residenti,NASCITA,2292,21444,23736
1,2025,Residenti,RESIDENZA,8083,322786,330869
1,2025,Residenti,RESIDENZA IN CONVIVENZA,7,335,342
1,2025,Residenti,STATO CIVILE,3207,20790,23997
1,2025,Residenti,STATO FAMIGLIA,9173,125813,134986
1,2025,Residenti,STATO FAMIGLIA CON RAPPORTI PARENTELA,1148,15630,16778
1,2025,Residenti,STATO FAMIGLIA E STATO CIVILE,1396,13410,14806
1,2025,Residenti,STATO LIBERO,3201,6389,9590
1,2025,Residenti,UNIONE CIVILE ,10,82,92
2,2025,AIRE,CITTADINANZA,17,115,132
2,2025,AIRE,CONTESTUALE,155,615,770
2,2025,AIRE,ESISTENZA IN VITA,0,3,3
2,2025,AIRE,GODIMENTO DEI DIRITTI POLITICI,2,2,4
2,2025,AIRE,ISCRIZIONE NELLE LISTE ELETTORALI,2,6,8
2,2025,AIRE,MATRIMONIO,42,188,230
2,2025,AIRE,NASCITA,301,432,733
2,2025,AIRE,RESIDENZA,191,1174,1365
2,2025,AIRE,STATO CIVILE,3,10,13
2,2025,AIRE,STATO FAMIGLIA,53,311,364
2,2025,AIRE,STATO FAMIGLIA CON RAPPORTI PARENTELA,2,2,4
2,2025,AIRE,STATO FAMIGLIA E STATO CIVILE,0,2,2
2,2025,AIRE,STATO LIBERO,3,1,4
2,2025,AIRE,UNIONE CIVILE ,2,1,3
2,2025,Residenti,CITTADINANZA,132,2932,3064
2,2025,Residenti,CONTESTUALE,16698,144845,161543
2,2025,Residenti,CONTRATTO CONVIVENZA,3,28,31
2,2025,Residenti,ESISTENZA IN VITA,219,3524,3743
2,2025,Residenti,GODIMENTO DEI DIRITTI POLITICI,89,258,347
2,2025,Residenti,ISCRIZIONE NELLE LISTE ELETTORALI,23,613,636
2,2025,Residenti,MATRIMONIO,1687,18117,19804
2,2025,Residenti,NASCITA,2159,18032,20191
2,2025,Residenti,RESIDENZA,7580,304492,312072
2,2025,Residenti,RESIDENZA IN CONVIVENZA,7,238,245
2,2025,Residenti,STATO CIVILE,2938,17148,20086
2,2025,Residenti,STATO FAMIGLIA,8792,88240,97032
2,2025,Residenti,STATO FAMIGLIA CON RAPPORTI PARENTELA,946,10294,11240
2,2025,Residenti,STATO FAMIGLIA E STATO CIVILE,1170,8732,9902
2,2025,Residenti,STATO LIBERO,2968,5068,8036
2,2025,Residenti,UNIONE CIVILE ,16,68,84
3,2025,AIRE,CITTADINANZA,24,112,136
3,2025,AIRE,CONTESTUALE,207,623,830
3,2025,AIRE,GODIMENTO DEI DIRITTI POLITICI,2,7,9
3,2025,AIRE,ISCRIZIONE NELLE LISTE ELETTORALI,0,14,14
3,2025,AIRE,MATRIMONIO,53,248,301
3,2025,AIRE,NASCITA,391,476,867
3,2025,AIRE,RESIDENZA,232,1115,1347
3,2025,AIRE,STATO CIVILE,5,11,16
3,2025,AIRE,STATO FAMIGLIA,54,359,413
3,2025,AIRE,STATO FAMIGLIA CON RAPPORTI PARENTELA,1,7,8
3,2025,AIRE,STATO LIBERO,3,3,6
3,2025,AIRE,UNIONE CIVILE ,0,3,3
3,2025,Residenti,CITTADINANZA,161,2931,3092
3,2025,Residenti,CONTESTUALE,18949,154001,172950
3,2025,Residenti,CONTRATTO CONVIVENZA,5,19,24
3,2025,Residenti,ESISTENZA IN VITA,254,3139,3393
3,2025,Residenti,GODIMENTO DEI DIRITTI POLITICI,95,294,389
3,2025,Residenti,ISCRIZIONE NELLE LISTE ELETTORALI,50,1196,1246
3,2025,Residenti,MATRIMONIO,1957,18164,20121
3,2025,Residenti,NASCITA,2455,17891,20346
3,2025,Residenti,RESIDENZA,8834,324050,332884
3,2025,Residenti,RESIDENZA IN CONVIVENZA,3,233,236
3,2025,Residenti,STATO CIVILE,3732,17333,21065
3,2025,Residenti,STATO FAMIGLIA,9548,83544,93092
3,2025,Residenti,STATO FAMIGLIA CON RAPPORTI PARENTELA,936,9114,10050
3,2025,Residenti,STATO FAMIGLIA E STATO CIVILE,1184,7898,9082
3,2025,Residenti,STATO LIBERO,3579,5427,9006
3,2025,Residenti,UNIONE CIVILE ,13,73,86
4,2025,AIRE,CITTADINANZA,35,144,179
4,2025,AIRE,CONTESTUALE,162,691,853
4,2025,AIRE,ESISTENZA IN VITA,0,1,1
4,2025,AIRE,GODIMENTO DEI DIRITTI POLITICI,3,6,9
4,2025,AIRE,ISCRIZIONE NELLE LISTE ELETTORALI,3,20,23
4,2025,AIRE,MATRIMONIO,53,209,262
4,2025,AIRE,NASCITA,339,417,756
4,2025,AIRE,RESIDENZA,245,1038,1283
4,2025,AIRE,STATO CIVILE,2,9,11
4,2025,AIRE,STATO FAMIGLIA,52,357,409
4,2025,AIRE,STATO FAMIGLIA CON RAPPORTI PARENTELA,1,4,5
4,2025,AIRE,STATO FAMIGLIA E STATO CIVILE,0,2,2
4,2025,AIRE,STATO LIBERO,2,1,3
4,2025,AIRE,UNIONE CIVILE ,0,2,2
4,2025,Residenti,CITTADINANZA,151,2701,2852
4,2025,Residenti,CONTESTUALE,16342,135888,152230
4,2025,Residenti,CONTRATTO CONVIVENZA,2,20,22
4,2025,Residenti,ESISTENZA IN VITA,214,2700,2914
4,2025,Residenti,GODIMENTO DEI DIRITTI POLITICI,87,514,601
4,2025,Residenti,ISCRIZIONE NELLE LISTE ELETTORALI,93,2053,2146
4,2025,Residenti,MATRIMONIO,1847,16265,18112
4,2025,Residenti,NASCITA,2456,16907,19363
4,2025,Residenti,RESIDENZA,7991,288924,296915
4,2025,Residenti,RESIDENZA IN CONVIVENZA,2,193,195
4,2025,Residenti,STATO CIVILE,3336,15328,18664
4,2025,Residenti,STATO FAMIGLIA,8758,73232,81990
4,2025,Residenti,STATO FAMIGLIA CON RAPPORTI PARENTELA,817,8104,8921
4,2025,Residenti,STATO FAMIGLIA E STATO CIVILE,1026,6865,7891
4,2025,Residenti,STATO LIBERO,3358,4625,7983
4,2025,Residenti,UNIONE CIVILE ,12,84,96
5,2025,AIRE,CITTADINANZA,27,153,180
5,2025,AIRE,CONTESTUALE,182,635,817
5,2025,AIRE,ESISTENZA IN VITA,0,6,6
5,2025,AIRE,GODIMENTO DEI DIRITTI POLITICI,1,10,11
5,2025,AIRE,ISCRIZIONE NELLE LISTE ELETTORALI,1,33,34
5,2025,AIRE,MATRIMONIO,46,228,274
5,2025,AIRE,NASCITA,440,466,906
5,2025,AIRE,RESIDENZA,235,1164,1399
5,2025,AIRE,STATO CIVILE,3,7,10
5,2025,AIRE,STATO FAMIGLIA,73,374,447
5,2025,AIRE,STATO FAMIGLIA CON RAPPORTI PARENTELA,1,2,3
5,2025,AIRE,STATO FAMIGLIA E STATO CIVILE,0,4,4
5,2025,AIRE,STATO LIBERO,2,4,6
5,2025,AIRE,UNIONE CIVILE ,1,1,2
5,2025,Residenti,CITTADINANZA,129,2887,3016
5,2025,Residenti,CONTESTUALE,17623,148553,166176
5,2025,Residenti,CONTRATTO CONVIVENZA,7,24,31
5,2025,Residenti,ESISTENZA IN VITA,222,3099,3321
5,2025,Residenti,GODIMENTO DEI DIRITTI POLITICI,144,1193,1337
5,2025,Residenti,ISCRIZIONE NELLE LISTE ELETTORALI,67,1943,2010
5,2025,Residenti,MATRIMONIO,2120,18130,20250
5,2025,Residenti,NASCITA,2659,18483,21142
5,2025,Residenti,RESIDENZA,8887,318550,327437
5,2025,Residenti,RESIDENZA IN CONVIVENZA,6,209,215
5,2025,Residenti,STATO CIVILE,4033,17692,21725
5,2025,Residenti,STATO FAMIGLIA,9413,78996,88409
5,2025,Residenti,STATO FAMIGLIA CON RAPPORTI PARENTELA,943,9064,10007
5,2025,Residenti,STATO FAMIGLIA E STATO CIVILE,1088,7553,8641
5,2025,Residenti,STATO LIBERO,3818,5204,9022
5,2025,Residenti,UNIONE CIVILE ,15,83,98
6,2025,AIRE,CITTADINANZA,31,157,188
6,2025,AIRE,CONTESTUALE,135,594,729
6,2025,AIRE,ESISTENZA IN VITA,0,2,2
6,2025,AIRE,GODIMENTO DEI DIRITTI POLITICI,2,8,10
6,2025,AIRE,ISCRIZIONE NELLE LISTE ELETTORALI,1,17,18
6,2025,AIRE,MATRIMONIO,56,204,260
6,2025,AIRE,NASCITA,298,487,785
6,2025,AIRE,RESIDENZA,237,1134,1371
6,2025,AIRE,STATO CIVILE,4,13,17
6,2025,AIRE,STATO FAMIGLIA,42,398,440
6,2025,AIRE,STATO FAMIGLIA CON RAPPORTI PARENTELA,0,4,4
6,2025,AIRE,STATO FAMIGLIA E STATO CIVILE,0,4,4
6,2025,AIRE,STATO LIBERO,2,4,6
6,2025,AIRE,UNIONE CIVILE ,1,4,5
6,2025,Residenti,CITTADINANZA,141,2644,2785
6,2025,Residenti,CONTESTUALE,15753,142306,158059
6,2025,Residenti,CONTRATTO CONVIVENZA,5,29,34
6,2025,Residenti,ESISTENZA IN VITA,250,3059,3309
6,2025,Residenti,GODIMENTO DEI DIRITTI POLITICI,139,1598,1737
6,2025,Residenti,ISCRIZIONE NELLE LISTE ELETTORALI,59,2430,2489
6,2025,Residenti,MATRIMONIO,2321,16837,19158
6,2025,Residenti,NASCITA,2732,16456,19188
6,2025,Residenti,RESIDENZA,8231,298429,306660
6,2025,Residenti,RESIDENZA IN CONVIVENZA,4,182,186
6,2025,Residenti,STATO CIVILE,3698,16248,19946
6,2025,Residenti,STATO FAMIGLIA,8874,73411,82285
6,2025,Residenti,STATO FAMIGLIA CON RAPPORTI PARENTELA,857,7870,8727
6,2025,Residenti,STATO FAMIGLIA E STATO CIVILE,1094,6641,7735
6,2025,Residenti,STATO LIBERO,3435,4736,8171
6,2025,Residenti,UNIONE CIVILE ,26,82,108
7,2025,AIRE,CITTADINANZA,53,253,306
7,2025,AIRE,CONTESTUALE,169,683,852
7,2025,AIRE,ESISTENZA IN VITA,0,9,9
7,2025,AIRE,GODIMENTO DEI DIRITTI POLITICI,1,7,8
7,2025,AIRE,ISCRIZIONE NELLE LISTE ELETTORALI,2,14,16
7,2025,AIRE,MATRIMONIO,33,216,249
7,2025,AIRE,NASCITA,320,517,837
7,2025,AIRE,RESIDENZA,249,1267,1516
7,2025,AIRE,STATO CIVILE,4,6,10
7,2025,AIRE,STATO FAMIGLIA,48,403,451
7,2025,AIRE,STATO FAMIGLIA E STATO CIVILE,1,0,1
7,2025,AIRE,STATO LIBERO,1,2,3
7,2025,AIRE,UNIONE CIVILE ,1,3,4
7,2025,Residenti,CITTADINANZA,178,2916,3094
7,2025,Residenti,CONTESTUALE,15440,194509,209949
7,2025,Residenti,CONTRATTO CONVIVENZA,8,25,33
7,2025,Residenti,ESISTENZA IN VITA,247,3391,3638
7,2025,Residenti,GODIMENTO DEI DIRITTI POLITICI,88,244,332
7,2025,Residenti,ISCRIZIONE NELLE LISTE ELETTORALI,22,356,378
7,2025,Residenti,MATRIMONIO,2455,18617,21072
7,2025,Residenti,NASCITA,2873,20338,23211
7,2025,Residenti,RESIDENZA,9108,334036,343144
7,2025,Residenti,RESIDENZA IN CONVIVENZA,10,203,213
7,2025,Residenti,STATO CIVILE,3727,17525,21252
7,2025,Residenti,STATO FAMIGLIA,9645,91784,101429
7,2025,Residenti,STATO FAMIGLIA CON RAPPORTI PARENTELA,1029,9581,10610
7,2025,Residenti,STATO FAMIGLIA E STATO CIVILE,1184,7524,8708
7,2025,Residenti,STATO LIBERO,3345,4716,8061
7,2025,Residenti,UNIONE CIVILE ,19,99,118
8,2025,AIRE,CITTADINANZA,54,160,214
8,2025,AIRE,CONTESTUALE,131,461,592
8,2025,AIRE,ESISTENZA IN VITA,0,5,5
8,2025,AIRE,GODIMENTO DEI DIRITTI POLITICI,3,0,3
8,2025,AIRE,ISCRIZIONE NELLE LISTE ELETTORALI,2,13,15
8,2025,AIRE,MATRIMONIO,39,200,239
8,2025,AIRE,NASCITA,272,391,663
8,2025,AIRE,RESIDENZA,178,834,1012
8,2025,AIRE,STATO CIVILE,0,8,8
8,2025,AIRE,STATO FAMIGLIA,40,280,320
8,2025,AIRE,STATO FAMIGLIA CON RAPPORTI PARENTELA,0,1,1
8,2025,AIRE,STATO FAMIGLIA E STATO CIVILE,2,0,2
8,2025,AIRE,STATO LIBERO,0,1,1
8,2025,Residenti,CITTADINANZA,131,2016,2147
8,2025,Residenti,CONTESTUALE,8946,118633,127579
8,2025,Residenti,CONTRATTO CONVIVENZA,2,12,14
8,2025,Residenti,ESISTENZA IN VITA,156,1618,1774
8,2025,Residenti,GODIMENTO DEI DIRITTI POLITICI,89,207,296
8,2025,Residenti,ISCRIZIONE NELLE LISTE ELETTORALI,36,679,715
8,2025,Residenti,MATRIMONIO,1314,8923,10237
8,2025,Residenti,NASCITA,2577,14535,17112
8,2025,Residenti,RESIDENZA,6170,146579,152749
8,2025,Residenti,RESIDENZA IN CONVIVENZA,2,126,128
8,2025,Residenti,STATO CIVILE,1419,8001,9420
8,2025,Residenti,STATO FAMIGLIA,6180,57643,63823
8,2025,Residenti,STATO FAMIGLIA CON RAPPORTI PARENTELA,685,6761,7446
8,2025,Residenti,STATO FAMIGLIA E STATO CIVILE,645,4753,5398
8,2025,Residenti,STATO LIBERO,1200,1862,3062
8,2025,Residenti,UNIONE CIVILE ,19,39,58
9,2025,AIRE,CITTADINANZA,78,196,274
9,2025,AIRE,CONTESTUALE,148,642,790
9,2025,AIRE,ESISTENZA IN VITA,0,5,5
9,2025,AIRE,GODIMENTO DEI DIRITTI POLITICI,0,5,5
9,2025,AIRE,ISCRIZIONE NELLE LISTE ELETTORALI,1,11,12
9,2025,AIRE,MATRIMONIO,44,242,286
9,2025,AIRE,NASCITA,350,525,875
9,2025,AIRE,RESIDENZA,224,1225,1449
9,2025,AIRE,STATO CIVILE,6,8,14
9,2025,AIRE,STATO FAMIGLIA,56,399,455
9,2025,AIRE,STATO FAMIGLIA CON RAPPORTI PARENTELA,0,3,3
9,2025,AIRE,STATO FAMIGLIA E STATO CIVILE,0,1,1
9,2025,AIRE,STATO LIBERO,4,0,4
9,2025,AIRE,UNIONE CIVILE ,0,5,5
9,2025,Residenti,CITTADINANZA,171,2876,3047
9,2025,Residenti,CONTESTUALE,17667,265320,282987
9,2025,Residenti,CONTRATTO CONVIVENZA,5,25,30
9,2025,Residenti,ESISTENZA IN VITA,296,3587,3883
9,2025,Residenti,GODIMENTO DEI DIRITTI POLITICI,153,417,570
9,2025,Residenti,ISCRIZIONE NELLE LISTE ELETTORALI,33,848,881
9,2025,Residenti,MATRIMONIO,2975,20396,23371
9,2025,Residenti,NASCITA,3526,23837,27363
9,2025,Residenti,RESIDENZA,10316,334842,345158
9,2025,Residenti,RESIDENZA IN CONVIVENZA,7,222,229
9,2025,Residenti,STATO CIVILE,4388,18819,23207
9,2025,Residenti,STATO FAMIGLIA,11216,110498,121714
9,2025,Residenti,STATO FAMIGLIA CON RAPPORTI PARENTELA,1065,11135,12200
9,2025,Residenti,STATO FAMIGLIA E STATO CIVILE,1259,8406,9665
9,2025,Residenti,STATO LIBERO,3844,5465,9309
9,2025,Residenti,UNIONE CIVILE ,34,104,138