MESE,ANNO,TIPO_SOGGETTO,TIPOLOGIA_CERTIFICATO,BOLLO,ESENTI_DA_BOLLO,TOTALE
11,2021,AIRE,CITTADINANZA,296,191,487
11,2021,AIRE,CONTESTUALE,914,814,1728
11,2021,AIRE,ESISTENZA IN VITA,3,0,3
11,2021,AIRE,MATRIMONIO,222,270,492
11,2021,AIRE,NASCITA,448,380,828
11,2021,AIRE,RESIDENZA,648,695,1343
11,2021,AIRE,STATO CIVILE,11,4,15
11,2021,AIRE,STATO FAMIGLIA,364,410,774
11,2021,AIRE,STATO FAMIGLIA CON RAPPORTI PARENTELA,2,0,2
11,2021,AIRE,STATO FAMIGLIA E STATO CIVILE,4,2,6
11,2021,AIRE,STATO LIBERO,3,1,4
11,2021,AIRE,UNIONE CIVILE ,0,4,4
11,2021,Residenti,CITTADINANZA,4969,3810,8779
11,2021,Residenti,CONTESTUALE,52356,54337,106693
11,2021,Residenti,CONTRATTO CONVIVENZA,24,11,35
11,2021,Residenti,ESISTENZA IN VITA,4463,4941,9404
11,2021,Residenti,MATRIMONIO,14118,21307,35425
11,2021,Residenti,NASCITA,21977,29838,51815
11,2021,Residenti,RESIDENZA,40070,51727,91797
11,2021,Residenti,RESIDENZA IN CONVIVENZA,47,63,110
11,2021,Residenti,STATO CIVILE,11072,11856,22928
11,2021,Residenti,STATO FAMIGLIA,35622,48873,84495
11,2021,Residenti,STATO FAMIGLIA CON RAPPORTI PARENTELA,12199,15360,27559
11,2021,Residenti,STATO FAMIGLIA E STATO CIVILE,11156,13999,25155
11,2021,Residenti,STATO LIBERO,5465,3734,9199
11,2021,Residenti,UNIONE CIVILE ,178,158,336
12,2021,AIRE,CITTADINANZA,155,104,259
12,2021,AIRE,CONTESTUALE,451,306,757
12,2021,AIRE,ESISTENZA IN VITA,4,0,4
12,2021,AIRE,MATRIMONIO,177,140,317
12,2021,AIRE,NASCITA,308,242,550
12,2021,AIRE,RESIDENZA,426,401,827
12,2021,AIRE,STATO CIVILE,6,2,8
12,2021,AIRE,STATO FAMIGLIA,230,216,446
12,2021,AIRE,STATO FAMIGLIA CON RAPPORTI PARENTELA,0,2,2
12,2021,AIRE,STATO FAMIGLIA E STATO CIVILE,4,2,6
12,2021,AIRE,STATO LIBERO,2,0,2
12,2021,AIRE,UNIONE CIVILE ,2,3,5
12,2021,Residenti,CITTADINANZA,3230,1403,4633
12,2021,Residenti,CONTESTUALE,35878,30915,66793
12,2021,Residenti,CONTRATTO CONVIVENZA,7,6,13
12,2021,Residenti,ESISTENZA IN VITA,2617,2025,4642
12,2021,Residenti,MATRIMONIO,8808,9432,18240
12,2021,Residenti,NASCITA,12044,11051,23095
12,2021,Residenti,RESIDENZA,31706,35683,67389
12,2021,Residenti,RESIDENZA IN CONVIVENZA,37,30,67
12,2021,Residenti,STATO CIVILE,8769,7208,15977
12,2021,Residenti,STATO FAMIGLIA,29065,33594,62659
12,2021,Residenti,STATO FAMIGLIA CON RAPPORTI PARENTELA,7597,7141,14738
12,2021,Residenti,STATO FAMIGLIA E STATO CIVILE,7128,6231,13359
12,2021,Residenti,STATO LIBERO,5044,3008,8052
12,2021,Residenti,UNIONE CIVILE ,37,39,76
1,2022,AIRE,CITTADINANZA,150,88,238
1,2022,AIRE,CONTESTUALE,375,316,691
1,2022,AIRE,ESISTENZA IN VITA,0,1,1
1,2022,AIRE,MATRIMONIO,112,132,244
1,2022,AIRE,NASCITA,319,279,598
1,2022,AIRE,RESIDENZA,316,336,652
1,2022,AIRE,STATO CIVILE,6,6,12
1,2022,AIRE,STATO FAMIGLIA,188,214,402
1,2022,AIRE,STATO FAMIGLIA CON RAPPORTI PARENTELA,2,2,4
1,2022,AIRE,STATO FAMIGLIA E STATO CIVILE,1,1,2
1,2022,AIRE,STATO LIBERO,5,2,7
1,2022,AIRE,UNIONE CIVILE ,1,2,3
1,2022,Residenti,CITTADINANZA,1749,1568,3317
1,2022,Residenti,CONTESTUALE,39601,39451,79052
1,2022,Residenti,CONTRATTO CONVIVENZA,19,9,28
1,2022,Residenti,ESISTENZA IN VITA,1682,2247,3929
1,2022,Residenti,MATRIMONIO,8093,10956,19049
1,2022,Residenti,NASCITA,11235,12614,23849
1,2022,Residenti,RESIDENZA,36065,47641,83706
1,2022,Residenti,RESIDENZA IN CONVIVENZA,46,41,87
1,2022,Residenti,STATO CIVILE,8081,8847,16928
1,2022,Residenti,STATO FAMIGLIA,47651,61277,108928
1,2022,Residenti,STATO FAMIGLIA CON RAPPORTI PARENTELA,8206,10511,18717
1,2022,Residenti,STATO FAMIGLIA E STATO CIVILE,7433,8970,16403
1,2022,Residenti,STATO LIBERO,5083,3633,8716
1,2022,Residenti,UNIONE CIVILE ,35,40,75
2,2022,AIRE,CITTADINANZA,102,76,178
2,2022,AIRE,CONTESTUALE,330,330,660
2,2022,AIRE,ESISTENZA IN VITA,1,1,2
2,2022,AIRE,MATRIMONIO,105,135,240
2,2022,AIRE,NASCITA,302,249,551
2,2022,AIRE,RESIDENZA,319,339,658
2,2022,AIRE,STATO CIVILE,1,7,8
2,2022,AIRE,STATO FAMIGLIA,187,189,376
2,2022,AIRE,STATO FAMIGLIA CON RAPPORTI PARENTELA,0,5,5
2,2022,AIRE,STATO FAMIGLIA E STATO CIVILE,2,3,5
2,2022,AIRE,STATO LIBERO,0,1,1
2,2022,AIRE,UNIONE CIVILE ,4,2,6
2,2022,Residenti,CITTADINANZA,1772,1443,3215
2,2022,Residenti,CONTESTUALE,41699,40160,81859
2,2022,Residenti,CONTRATTO CONVIVENZA,11,9,20
2,2022,Residenti,ESISTENZA IN VITA,1326,1683,3009
2,2022,Residenti,MATRIMONIO,8488,11214,19702
2,2022,Residenti,NASCITA,10203,11625,21828
2,2022,Residenti,RESIDENZA,32811,42296,75107
2,2022,Residenti,RESIDENZA IN CONVIVENZA,45,41,86
2,2022,Residenti,STATO CIVILE,8720,9665,18385
2,2022,Residenti,STATO FAMIGLIA,37453,48938,86391
2,2022,Residenti,STATO FAMIGLIA CON RAPPORTI PARENTELA,6520,8468,14988
2,2022,Residenti,STATO FAMIGLIA E STATO CIVILE,6632,7887,14519
2,2022,Residenti,STATO LIBERO,5879,4487,10366
2,2022,Residenti,UNIONE CIVILE ,42,39,81
3,2022,AIRE,CITTADINANZA,98,84,182
3,2022,AIRE,CONTESTUALE,347,329,676
3,2022,AIRE,ESISTENZA IN VITA,0,1,1
3,2022,AIRE,MATRIMONIO,99,127,226
3,2022,AIRE,NASCITA,292,288,580
3,2022,AIRE,RESIDENZA,267,336,603
3,2022,AIRE,STATO CIVILE,7,13,20
3,2022,AIRE,STATO FAMIGLIA,186,205,391
3,2022,AIRE,STATO FAMIGLIA CON RAPPORTI PARENTELA,6,0,6
3,2022,AIRE,STATO FAMIGLIA E STATO CIVILE,5,4,9
3,2022,AIRE,STATO LIBERO,4,4,8
3,2022,AIRE,UNIONE CIVILE ,7,1,8
3,2022,Residenti,CITTADINANZA,2089,1406,3495
3,2022,Residenti,CONTESTUALE,46122,42863,88985
3,2022,Residenti,CONTRATTO CONVIVENZA,7,9,16
3,2022,Residenti,ESISTENZA IN VITA,1397,1510,2907
3,2022,Residenti,MATRIMONIO,9400,12223,21623
3,2022,Residenti,NASCITA,11122,12294,23416
3,2022,Residenti,RESIDENZA,37411,46496,83907
3,2022,Residenti,RESIDENZA IN CONVIVENZA,57,44,101
3,2022,Residenti,STATO CIVILE,9847,10097,19944
3,2022,Residenti,STATO FAMIGLIA,36238,46070,82308
3,2022,Residenti,STATO FAMIGLIA CON RAPPORTI PARENTELA,6492,8224,14716
3,2022,Residenti,STATO FAMIGLIA E STATO CIVILE,6732,7667,14399
3,2022,Residenti,STATO LIBERO,6607,5063,11670
3,2022,Residenti,UNIONE CIVILE ,40,48,88
4,2022,AIRE,CITTADINANZA,96,87,183
4,2022,AIRE,CONTESTUALE,346,283,629
4,2022,AIRE,ESISTENZA IN VITA,1,1,2
4,2022,AIRE,MATRIMONIO,71,120,191
4,2022,AIRE,NASCITA,273,228,501
4,2022,AIRE,RESIDENZA,341,448,789
4,2022,AIRE,STATO CIVILE,4,4,8
4,2022,AIRE,STATO FAMIGLIA,160,204,364
4,2022,AIRE,STATO FAMIGLIA CON RAPPORTI PARENTELA,0,6,6
4,2022,AIRE,STATO FAMIGLIA E STATO CIVILE,3,2,5
4,2022,AIRE,STATO LIBERO,1,4,5
4,2022,AIRE,UNIONE CIVILE ,0,2,2
4,2022,Residenti,CITTADINANZA,1641,1204,2845
4,2022,Residenti,CONTESTUALE,36753,34735,71488
4,2022,Residenti,CONTRATTO CONVIVENZA,9,4,13
4,2022,Residenti,ESISTENZA IN VITA,1052,1285,2337
4,2022,Residenti,MATRIMONIO,7540,9512,17052
4,2022,Residenti,NASCITA,9164,9976,19140
4,2022,Residenti,RESIDENZA,32072,39930,72002
4,2022,Residenti,RESIDENZA IN CONVIVENZA,47,45,92
4,2022,Residenti,STATO CIVILE,7782,8352,16134
4,2022,Residenti,STATO FAMIGLIA,27806,34678,62484
4,2022,Residenti,STATO FAMIGLIA CON RAPPORTI PARENTELA,5305,6371,11676
4,2022,Residenti,STATO FAMIGLIA E STATO CIVILE,5329,5973,11302
4,2022,Residenti,STATO LIBERO,5494,4270,9764
4,2022,Residenti,UNIONE CIVILE ,51,36,87
5,2022,AIRE,CITTADINANZA,112,86,198
5,2022,AIRE,CONTESTUALE,395,321,716
5,2022,AIRE,MATRIMONIO,116,138,254
5,2022,AIRE,NASCITA,335,245,580
5,2022,AIRE,RESIDENZA,358,416,774
5,2022,AIRE,STATO CIVILE,8,10,18
5,2022,AIRE,STATO FAMIGLIA,188,189,377
5,2022,AIRE,STATO FAMIGLIA CON RAPPORTI PARENTELA,1,5,6
5,2022,AIRE,STATO FAMIGLIA E STATO CIVILE,3,2,5
5,2022,AIRE,STATO LIBERO,4,3,7
5,2022,AIRE,UNIONE CIVILE ,0,1,1
5,2022,Residenti,CITTADINANZA,1764,1367,3131
5,2022,Residenti,CONTESTUALE,40290,38775,79065
5,2022,Residenti,CONTRATTO CONVIVENZA,19,7,26
5,2022,Residenti,ESISTENZA IN VITA,1171,1377,2548
5,2022,Residenti,MATRIMONIO,8369,11039,19408
5,2022,Residenti,NASCITA,9857,11384,21241
5,2022,Residenti,RESIDENZA,38619,46701,85320
5,2022,Residenti,RESIDENZA IN CONVIVENZA,43,52,95
5,2022,Residenti,STATO CIVILE,9324,9930,19254
5,2022,Residenti,STATO FAMIGLIA,33281,41462,74743
5,2022,Residenti,STATO FAMIGLIA CON RAPPORTI PARENTELA,5998,7391,13389
5,2022,Residenti,STATO FAMIGLIA E STATO CIVILE,6023,6939,12962
5,2022,Residenti,STATO LIBERO,6298,4991,11289
5,2022,Residenti,UNIONE CIVILE ,38,33,71
6,2022,AIRE,CITTADINANZA,123,82,205
6,2022,AIRE,CONTESTUALE,321,257,578
6,2022,AIRE,MATRIMONIO,85,101,186
6,2022,AIRE,NASCITA,285,226,511
6,2022,AIRE,RESIDENZA,291,380,671
6,2022,AIRE,STATO CIVILE,6,6,12
6,2022,AIRE,STATO FAMIGLIA,176,209,385
6,2022,AIRE,STATO FAMIGLIA CON RAPPORTI PARENTELA,2,5,7
6,2022,AIRE,STATO FAMIGLIA E STATO CIVILE,2,1,3
6,2022,AIRE,STATO LIBERO,4,2,6
6,2022,AIRE,UNIONE CIVILE ,1,0,1
6,2022,Residenti,CITTADINANZA,1799,1390,3189
6,2022,Residenti,CONTESTUALE,36992,37037,74029
6,2022,Residenti,CONTRATTO CONVIVENZA,17,6,23
6,2022,Residenti,ESISTENZA IN VITA,1081,1377,2458
6,2022,Residenti,MATRIMONIO,8440,10567,19007
6,2022,Residenti,NASCITA,9161,10058,19219
6,2022,Residenti,RESIDENZA,35264,43644,78908
6,2022,Residenti,RESIDENZA IN CONVIVENZA,39,44,83
6,2022,Residenti,STATO CIVILE,8930,9558,18488
6,2022,Residenti,STATO FAMIGLIA,30461,38089,68550
6,2022,Residenti,STATO FAMIGLIA CON RAPPORTI PARENTELA,5612,6727,12339
6,2022,Residenti,STATO FAMIGLIA E STATO CIVILE,5340,6399,11739
6,2022,Residenti,STATO LIBERO,5701,4750,10451
6,2022,Residenti,UNIONE CIVILE ,41,40,81
7,2022,AIRE,CITTADINANZA,94,76,170
7,2022,AIRE,CONTESTUALE,300,262,562
7,2022,AIRE,ESISTENZA IN VITA,2,0,2
7,2022,AIRE,MATRIMONIO,109,121,230
7,2022,AIRE,NASCITA,264,223,487
7,2022,AIRE,RESIDENZA,320,366,686
7,2022,AIRE,STATO CIVILE,6,6,12
7,2022,AIRE,STATO FAMIGLIA,182,188,370
7,2022,AIRE,STATO FAMIGLIA CON RAPPORTI PARENTELA,1,1,2
7,2022,AIRE,STATO FAMIGLIA E STATO CIVILE,1,2,3
7,2022,AIRE,STATO LIBERO,1,0,1
7,2022,AIRE,UNIONE CIVILE ,2,0,2
7,2022,Residenti,CITTADINANZA,1550,1188,2738
7,2022,Residenti,CONTESTUALE,32025,44448,76473
7,2022,Residenti,CONTRATTO CONVIVENZA,15,16,31
7,2022,Residenti,ESISTENZA IN VITA,1043,1299,2342
7,2022,Residenti,MATRIMONIO,8067,9857,17924
7,2022,Residenti,NASCITA,8594,9660,18254
7,2022,Residenti,RESIDENZA,32593,40603,73196
7,2022,Residenti,RESIDENZA IN CONVIVENZA,40,29,69
7,2022,Residenti,STATO CIVILE,7907,8472,16379
7,2022,Residenti,STATO FAMIGLIA,27247,36992,64239
7,2022,Residenti,STATO FAMIGLIA CON RAPPORTI PARENTELA,5205,6560,11765
7,2022,Residenti,STATO FAMIGLIA E STATO CIVILE,4968,5554,10522
7,2022,Residenti,STATO LIBERO,4877,4122,8999
7,2022,Residenti,UNIONE CIVILE ,52,50,102
8,2022,AIRE,CITTADINANZA,104,69,173
8,2022,AIRE,CONTESTUALE,332,271,603
8,2022,AIRE,ESISTENZA IN VITA,2,0,2
8,2022,AIRE,MATRIMONIO,87,87,174
8,2022,AIRE,NASCITA,339,271,610
8,2022,AIRE,RESIDENZA,315,364,679
8,2022,AIRE,STATO CIVILE,5,1,6
8,2022,AIRE,STATO FAMIGLIA,175,179,354
8,2022,AIRE,STATO FAMIGLIA CON RAPPORTI PARENTELA,7,4,11
8,2022,AIRE,STATO FAMIGLIA E STATO CIVILE,1,1,2
8,2022,AIRE,STATO LIBERO,2,0,2
8,2022,AIRE,UNIONE CIVILE ,0,3,3
8,2022,Residenti,CITTADINANZA,1382,1024,2406
8,2022,Residenti,CONTESTUALE,24106,35093,59199
8,2022,Residenti,CONTRATTO CONVIVENZA,13,11,24
8,2022,Residenti,ESISTENZA IN VITA,799,964,1763
8,2022,Residenti,ISCRIZIONE NELLE LISTE ELETTORALI,0,1,1
8,2022,Residenti,MATRIMONIO,5390,5999,11389
8,2022,Residenti,NASCITA,7909,8476,16385
8,2022,Residenti,RESIDENZA,27609,33924,61533
8,2022,Residenti,RESIDENZA IN CONVIVENZA,25,40,65
8,2022,Residenti,STATO CIVILE,4638,5121,9759
8,2022,Residenti,STATO FAMIGLIA,21752,29627,51379
8,2022,Residenti,STATO FAMIGLIA CON RAPPORTI PARENTELA,4245,5404,9649
8,2022,Residenti,STATO FAMIGLIA E STATO CIVILE,3429,4096,7525
8,2022,Residenti,STATO LIBERO,2329,1885,4214
8,2022,Residenti,UNIONE CIVILE ,32,35,67
9,2022,AIRE,CITTADINANZA,127,62,189
9,2022,AIRE,CONTESTUALE,330,290,620
9,2022,AIRE,ESISTENZA IN VITA,3,4,7
9,2022,AIRE,MATRIMONIO,120,123,243
9,2022,AIRE,NASCITA,302,276,578
9,2022,AIRE,RESIDENZA,297,403,700
9,2022,AIRE,STATO CIVILE,11,5,16
9,2022,AIRE,STATO FAMIGLIA,187,197,384
9,2022,AIRE,STATO FAMIGLIA CON RAPPORTI PARENTELA,7,3,10
9,2022,AIRE,STATO FAMIGLIA E STATO CIVILE,3,0,3
9,2022,AIRE,STATO LIBERO,5,4,9
9,2022,Residenti,CITTADINANZA,2251,1877,4128
9,2022,Residenti,CONTESTUALE,42856,85887,128743
9,2022,Residenti,CONTRATTO CONVIVENZA,11,21,32
9,2022,Residenti,ESISTENZA IN VITA,1358,1399,2757
9,2022,Residenti,MATRIMONIO,9565,12018,21583
9,2022,Residenti,NASCITA,11005,14308,25313
9,2022,Residenti,RESIDENZA,40649,53483,94132
9,2022,Residenti,RESIDENZA IN CONVIVENZA,53,59,112
9,2022,Residenti,STATO CIVILE,9357,10151,19508
9,2022,Residenti,STATO FAMIGLIA,35183,55514,90697
9,2022,Residenti,STATO FAMIGLIA CON RAPPORTI PARENTELA,6480,8544,15024
9,2022,Residenti,STATO FAMIGLIA E STATO CIVILE,5688,6986,12674
9,2022,Residenti,STATO LIBERO,5631,4880,10511
9,2022,Residenti,UNIONE CIVILE ,46,62,108
10,2022,AIRE,CITTADINANZA,126,73,199
10,2022,AIRE,CONTESTUALE,346,317,663
10,2022,AIRE,ESISTENZA IN VITA,1,0,1
10,2022,AIRE,MATRIMONIO,112,114,226
10,2022,AIRE,NASCITA,341,269,610
10,2022,AIRE,RESIDENZA,352,388,740
10,2022,AIRE,STATO CIVILE,13,6,19
10,2022,AIRE,STATO FAMIGLIA,197,208,405
10,2022,AIRE,STATO FAMIGLIA CON RAPPORTI PARENTELA,7,5,12
10,2022,AIRE,STATO FAMIGLIA E STATO CIVILE,5,3,8
10,2022,AIRE,STATO LIBERO,6,5,11
10,2022,Residenti,CITTADINANZA,2082,1751,3833
10,2022,Residenti,CONTESTUALE,42131,68138,110269
10,2022,Residenti,CONTRATTO CONVIVENZA,14,17,31
10,2022,Residenti,ESISTENZA IN VITA,1289,1429,2718
10,2022,Residenti,GODIMENTO DEI DIRITTI POLITICI,0,1,1
10,2022,Residenti,ISCRIZIONE NELLE LISTE ELETTORALI,0,1,1
10,2022,Residenti,MATRIMONIO,9493,11654,21147
10,2022,Residenti,NASCITA,10287,12912,23199
10,2022,Residenti,RESIDENZA,40374,52483,92857
10,2022,Residenti,RESIDENZA IN CONVIVENZA,50,50,100
10,2022,Residenti,STATO CIVILE,9053,9909,18962
10,2022,Residenti,STATO FAMIGLIA,35802,50445,86247
10,2022,Residenti,STATO FAMIGLIA CON RAPPORTI PARENTELA,6609,8442,15051
10,2022,Residenti,STATO FAMIGLIA E STATO CIVILE,6136,7375,13511
10,2022,Residenti,STATO LIBERO,5078,4548,9626
10,2022,Residenti,UNIONE CIVILE ,54,48,102
11,2022,AIRE,CITTADINANZA,145,66,211
11,2022,AIRE,CONTESTUALE,381,336,717
11,2022,AIRE,ESISTENZA IN VITA,2,1,3
11,2022,AIRE,MATRIMONIO,118,123,241
11,2022,AIRE,NASCITA,354,270,624
11,2022,AIRE,RESIDENZA,349,344,693
11,2022,AIRE,STATO CIVILE,9,3,12
11,2022,AIRE,STATO FAMIGLIA,204,197,401
11,2022,AIRE,STATO FAMIGLIA CON RAPPORTI PARENTELA,3,2,5
11,2022,AIRE,STATO FAMIGLIA E STATO CIVILE,4,6,10
11,2022,AIRE,STATO LIBERO,1,2,3
11,2022,AIRE,UNIONE CIVILE ,0,1,1
11,2022,Residenti,CITTADINANZA,2261,1693,3954
11,2022,Residenti,CONTESTUALE,40166,50195,90361
11,2022,Residenti,CONTRATTO CONVIVENZA,17,8,25
11,2022,Residenti,ESISTENZA IN VITA,1411,1599,3010
11,2022,Residenti,GODIMENTO DEI DIRITTI POLITICI,0,3,3
11,2022,Residenti,ISCRIZIONE NELLE LISTE ELETTORALI,0,1,1
11,2022,Residenti,MATRIMONIO,8828,11599,20427
11,2022,Residenti,NASCITA,10370,11899,22269
11,2022,Residenti,RESIDENZA,39668,48762,88430
11,2022,Residenti,RESIDENZA IN CONVIVENZA,50,48,98
11,2022,Residenti,STATO CIVILE,9669,10228,19897
11,2022,Residenti,STATO FAMIGLIA,33635,45383,79018
11,2022,Residenti,STATO FAMIGLIA CON RAPPORTI PARENTELA,6881,8581,15462
11,2022,Residenti,STATO FAMIGLIA E STATO CIVILE,5979,6982,12961
11,2022,Residenti,STATO LIBERO,5502,4994,10496
11,2022,Residenti,UNIONE CIVILE ,62,37,99
12,2022,AIRE,CITTADINANZA,173,59,232
12,2022,AIRE,CONTESTUALE,437,311,748
12,2022,AIRE,ESISTENZA IN VITA,1,1,2
12,2022,AIRE,MATRIMONIO,111,113,224
12,2022,AIRE,NASCITA,330,245,575
12,2022,AIRE,RESIDENZA,448,368,816
12,2022,AIRE,STATO CIVILE,8,6,14
12,2022,AIRE,STATO FAMIGLIA,241,187,428
12,2022,AIRE,STATO FAMIGLIA CON RAPPORTI PARENTELA,4,3,7
12,2022,AIRE,STATO FAMIGLIA E STATO CIVILE,2,2,4
12,2022,AIRE,STATO LIBERO,2,1,3
12,2022,AIRE,UNIONE CIVILE ,1,0,1
12,2022,Residenti,CITTADINANZA,2673,1381,4054
12,2022,Residenti,CONTESTUALE,34653,34612,69265
12,2022,Residenti,CONTRATTO CONVIVENZA,18,9,27
12,2022,Residenti,ESISTENZA IN VITA,1955,1538,3493
12,2022,Residenti,MATRIMONIO,7292,8390,15682
12,2022,Residenti,NASCITA,9740,9087,18827
12,2022,Residenti,RESIDENZA,35140,40075,75215
12,2022,Residenti,RESIDENZA IN CONVIVENZA,44,52,96
12,2022,Residenti,STATO CIVILE,8357,7922,16279
12,2022,Residenti,STATO FAMIGLIA,29682,35130,64812
12,2022,Residenti,STATO FAMIGLIA CON RAPPORTI PARENTELA,6634,6776,13410
12,2022,Residenti,STATO FAMIGLIA E STATO CIVILE,5835,5355,11190
12,2022,Residenti,STATO LIBERO,4852,3379,8231
12,2022,Residenti,UNIONE CIVILE ,42,35,77
1,2023,AIRE,CITTADINANZA,13,187,200
1,2023,AIRE,CONTESTUALE,38,826,864
1,2023,AIRE,ESISTENZA IN VITA,0,4,4
1,2023,AIRE,MATRIMONIO,14,221,235
1,2023,AIRE,NASCITA,29,576,605
1,2023,AIRE,RESIDENZA,35,899,934
1,2023,AIRE,STATO CIVILE,2,21,23
1,2023,AIRE,STATO FAMIGLIA,23,417,440
1,2023,AIRE,STATO FAMIGLIA CON RAPPORTI PARENTELA,0,11,11
1,2023,AIRE,STATO FAMIGLIA E STATO CIVILE,0,6,6
1,2023,AIRE,STATO LIBERO,1,10,11
1,2023,AIRE,UNIONE CIVILE ,0,2,2
1,2023,Residenti,CITTADINANZA,136,3171,3307
1,2023,Residenti,CONTESTUALE,2291,90119,92410
1,2023,Residenti,CONTRATTO CONVIVENZA,0,26,26
1,2023,Residenti,ESISTENZA IN VITA,105,2998,3103
1,2023,Residenti,MATRIMONIO,408,17714,18122
1,2023,Residenti,NASCITA,711,22000,22711
1,2023,Residenti,RESIDENZA,2469,93849,96318
1,2023,Residenti,RESIDENZA IN CONVIVENZA,4,116,120
1,2023,Residenti,STATO CIVILE,439,17623,18062
1,2023,Residenti,STATO FAMIGLIA,3223,117465,120688
1,2023,Residenti,STATO FAMIGLIA CON RAPPORTI PARENTELA,464,18720,19184
1,2023,Residenti,STATO FAMIGLIA E STATO CIVILE,454,15323,15777
1,2023,Residenti,STATO LIBERO,212,7726,7938
1,2023,Residenti,UNIONE CIVILE ,2,76,78
2,2023,AIRE,CITTADINANZA,0,183,183
2,2023,AIRE,CONTESTUALE,0,735,735
2,2023,AIRE,ESISTENZA IN VITA,0,2,2
2,2023,AIRE,MATRIMONIO,0,232,232
2,2023,AIRE,NASCITA,0,597,597
2,2023,AIRE,RESIDENZA,0,758,758
2,2023,AIRE,STATO CIVILE,0,21,21
2,2023,AIRE,STATO FAMIGLIA,0,410,410
2,2023,AIRE,STATO FAMIGLIA CON RAPPORTI PARENTELA,0,11,11
2,2023,AIRE,STATO FAMIGLIA E STATO CIVILE,0,11,11
2,2023,AIRE,STATO LIBERO,0,11,11
2,2023,AIRE,UNIONE CIVILE ,0,6,6
2,2023,Residenti,CITTADINANZA,0,2964,2964
2,2023,Residenti,CONTESTUALE,0,86258,86258
2,2023,Residenti,CONTRATTO CONVIVENZA,0,18,18
2,2023,Residenti,ESISTENZA IN VITA,0,2287,2287
2,2023,Residenti,MATRIMONIO,0,18142,18142
2,2023,Residenti,NASCITA,0,19865,19865
2,2023,Residenti,RESIDENZA,0,87942,87942
2,2023,Residenti,RESIDENZA IN CONVIVENZA,0,106,106
2,2023,Residenti,STATO CIVILE,0,17817,17817
2,2023,Residenti,STATO FAMIGLIA,0,88417,88417
2,2023,Residenti,STATO FAMIGLIA CON RAPPORTI PARENTELA,0,14601,14601
2,2023,Residenti,STATO FAMIGLIA E STATO CIVILE,0,12998,12998
2,2023,Residenti,STATO LIBERO,0,8338,8338
2,2023,Residenti,UNIONE CIVILE ,0,79,79
3,2023,AIRE,CITTADINANZA,0,185,185
3,2023,AIRE,CONTESTUALE,0,764,764
3,2023,AIRE,ESISTENZA IN VITA,0,6,6
3,2023,AIRE,MATRIMONIO,0,284,284
3,2023,AIRE,NASCITA,0,562,562
3,2023,AIRE,RESIDENZA,0,899,899
3,2023,AIRE,STATO CIVILE,0,21,21
3,2023,AIRE,STATO FAMIGLIA,0,391,391
3,2023,AIRE,STATO FAMIGLIA CON RAPPORTI PARENTELA,0,15,15
3,2023,AIRE,STATO FAMIGLIA E STATO CIVILE,0,8,8
3,2023,AIRE,STATO LIBERO,0,8,8
3,2023,AIRE,UNIONE CIVILE ,0,2,2
3,2023,Residenti,CITTADINANZA,0,2958,2958
3,2023,Residenti,CONTESTUALE,0,85765,85765
3,2023,Residenti,CONTRATTO CONVIVENZA,0,23,23
3,2023,Residenti,ESISTENZA IN VITA,0,2345,2345
3,2023,Residenti,MATRIMONIO,0,17008,17008
3,2023,Residenti,NASCITA,0,19908,19908
3,2023,Residenti,RESIDENZA,0,88591,88591
3,2023,Residenti,RESIDENZA IN CONVIVENZA,0,101,101
3,2023,Residenti,STATO CIVILE,0,17280,17280
3,2023,Residenti,STATO FAMIGLIA,0,78001,78001
3,2023,Residenti,STATO FAMIGLIA CON RAPPORTI PARENTELA,0,13179,13179
3,2023,Residenti,STATO FAMIGLIA E STATO CIVILE,0,11768,11768
3,2023,Residenti,STATO LIBERO,0,7664,7664
3,2023,Residenti,UNIONE CIVILE ,0,81,81
4,2023,AIRE,CITTADINANZA,0,158,158
4,2023,AIRE,CONTESTUALE,0,623,623
4,2023,AIRE,ESISTENZA IN VITA,0,4,4
4,2023,AIRE,MATRIMONIO,0,190,190
4,2023,AIRE,NASCITA,0,445,445
4,2023,AIRE,RESIDENZA,0,702,702
4,2023,AIRE,STATO CIVILE,0,15,15
4,2023,AIRE,STATO FAMIGLIA,0,328,328
4,2023,AIRE,STATO FAMIGLIA CON RAPPORTI PARENTELA,0,5,5
4,2023,AIRE,STATO FAMIGLIA E STATO CIVILE,0,5,5
4,2023,AIRE,STATO LIBERO,0,7,7
4,2023,AIRE,UNIONE CIVILE ,0,3,3
4,2023,Residenti,CITTADINANZA,0,2345,2345
4,2023,Residenti,CONTESTUALE,0,63620,63620
4,2023,Residenti,CONTRATTO CONVIVENZA,0,13,13
4,2023,Residenti,ESISTENZA IN VITA,0,1629,1629
4,2023,Residenti,MATRIMONIO,0,11893,11893
4,2023,Residenti,NASCITA,0,14547,14547
4,2023,Residenti,RESIDENZA,0,69085,69085
4,2023,Residenti,RESIDENZA IN CONVIVENZA,0,88,88
4,2023,Residenti,STATO CIVILE,0,12486,12486
4,2023,Residenti,STATO FAMIGLIA,0,54535,54535
4,2023,Residenti,STATO FAMIGLIA CON RAPPORTI PARENTELA,0,9426,9426
4,2023,Residenti,STATO FAMIGLIA E STATO CIVILE,0,8593,8593
4,2023,Residenti,STATO LIBERO,0,5508,5508
4,2023,Residenti,UNIONE CIVILE ,0,63,63
5,2023,AIRE,CITTADINANZA,0,139,139
5,2023,AIRE,CONTESTUALE,0,619,619
5,2023,AIRE,ESISTENZA IN VITA,0,4,4
5,2023,AIRE,MATRIMONIO,0,240,240
5,2023,AIRE,NASCITA,0,449,449
5,2023,AIRE,RESIDENZA,0,792,792
5,2023,AIRE,STATO CIVILE,0,17,17
5,2023,AIRE,STATO FAMIGLIA,0,381,381
5,2023,AIRE,STATO FAMIGLIA CON RAPPORTI PARENTELA,0,8,8
5,2023,AIRE,STATO FAMIGLIA E STATO CIVILE,0,11,11
5,2023,AIRE,STATO LIBERO,0,8,8
5,2023,AIRE,UNIONE CIVILE ,0,4,4
5,2023,Residenti,CITTADINANZA,0,2759,2759
5,2023,Residenti,CONTESTUALE,0,78335,78335
5,2023,Residenti,CONTRATTO CONVIVENZA,0,14,14
5,2023,Residenti,ESISTENZA IN VITA,0,1960,1960
5,2023,Residenti,MATRIMONIO,0,16014,16014
5,2023,Residenti,NASCITA,0,17406,17406
5,2023,Residenti,RESIDENZA,0,84757,84757
5,2023,Residenti,RESIDENZA IN CONVIVENZA,0,118,118
5,2023,Residenti,STATO CIVILE,0,15948,15948
5,2023,Residenti,STATO FAMIGLIA,0,66027,66027
5,2023,Residenti,STATO FAMIGLIA CON RAPPORTI PARENTELA,0,11092,11092
5,2023,Residenti,STATO FAMIGLIA E STATO CIVILE,0,10380,10380
5,2023,Residenti,STATO LIBERO,0,6481,6481
5,2023,Residenti,UNIONE CIVILE ,0,95,95
6,2023,AIRE,CITTADINANZA,0,121,121
6,2023,AIRE,CONTESTUALE,0,591,591
6,2023,AIRE,ESISTENZA IN VITA,0,3,3
6,2023,AIRE,MATRIMONIO,0,182,182
6,2023,AIRE,NASCITA,0,466,466
6,2023,AIRE,RESIDENZA,0,759,759
6,2023,AIRE,STATO CIVILE,0,14,14
6,2023,AIRE,STATO FAMIGLIA,0,312,312
6,2023,AIRE,STATO FAMIGLIA CON RAPPORTI PARENTELA,0,4,4
6,2023,AIRE,STATO FAMIGLIA E STATO CIVILE,0,3,3
6,2023,AIRE,STATO LIBERO,0,6,6
6,2023,Residenti,CITTADINANZA,0,2485,2485
6,2023,Residenti,CONTESTUALE,0,67668,67668
6,2023,Residenti,CONTRATTO CONVIVENZA,0,11,11
6,2023,Residenti,ESISTENZA IN VITA,0,2084,2084
6,2023,Residenti,MATRIMONIO,0,14686,14686
6,2023,Residenti,NASCITA,0,15888,15888
6,2023,Residenti,RESIDENZA,0,75599,75599
6,2023,Residenti,RESIDENZA IN CONVIVENZA,0,85,85
6,2023,Residenti,STATO CIVILE,0,13712,13712
6,2023,Residenti,STATO FAMIGLIA,0,59998,59998
6,2023,Residenti,STATO FAMIGLIA CON RAPPORTI PARENTELA,0,10311,10311
6,2023,Residenti,STATO FAMIGLIA E STATO CIVILE,0,9035,9035
6,2023,Residenti,STATO LIBERO,0,5756,5756
6,2023,Residenti,UNIONE CIVILE ,0,70,70
7,2023,AIRE,CITTADINANZA,0,151,151
7,2023,AIRE,CONTESTUALE,0,608,608
7,2023,AIRE,ESISTENZA IN VITA,0,3,3
7,2023,AIRE,MATRIMONIO,0,198,198
7,2023,AIRE,NASCITA,0,481,481
7,2023,AIRE,RESIDENZA,0,652,652
7,2023,AIRE,STATO CIVILE,0,16,16
7,2023,AIRE,STATO FAMIGLIA,0,306,306
7,2023,AIRE,STATO FAMIGLIA CON RAPPORTI PARENTELA,0,6,6
7,2023,AIRE,STATO FAMIGLIA E STATO CIVILE,0,4,4
7,2023,AIRE,STATO LIBERO,0,7,7
7,2023,AIRE,UNIONE CIVILE ,0,6,6
7,2023,Residenti,CITTADINANZA,0,2204,2204
7,2023,Residenti,CONTESTUALE,0,83851,83851
7,2023,Residenti,CONTRATTO CONVIVENZA,0,16,16
7,2023,Residenti,ESISTENZA IN VITA,0,1835,1835
7,2023,Residenti,MATRIMONIO,0,14338,14338
7,2023,Residenti,NASCITA,0,16024,16024
7,2023,Residenti,RESIDENZA,0,73473,73473
7,2023,Residenti,RESIDENZA IN CONVIVENZA,0,90,90
7,2023,Residenti,STATO CIVILE,0,12775,12775
7,2023,Residenti,STATO FAMIGLIA,0,64362,64362
7,2023,Residenti,STATO FAMIGLIA CON RAPPORTI PARENTELA,0,10554,10554
7,2023,Residenti,STATO FAMIGLIA E STATO CIVILE,0,8319,8319
7,2023,Residenti,STATO LIBERO,0,5157,5157
7,2023,Residenti,UNIONE CIVILE ,0,97,97
8,2023,AIRE,CITTADINANZA,9,86,95
8,2023,AIRE,CONTESTUALE,61,378,439
8,2023,AIRE,MATRIMONIO,23,140,163
8,2023,AIRE,NASCITA,98,331,429
8,2023,AIRE,RESIDENZA,100,473,573
8,2023,AIRE,STATO CIVILE,2,11,13
8,2023,AIRE,STATO FAMIGLIA,22,206,228
8,2023,AIRE,STATO FAMIGLIA CON RAPPORTI PARENTELA,1,2,3
8,2023,AIRE,STATO FAMIGLIA E STATO CIVILE,0,1,1
8,2023,AIRE,STATO LIBERO,2,1,3
8,2023,AIRE,UNIONE CIVILE ,1,1,2
8,2023,Residenti,CITTADINANZA,69,1774,1843
8,2023,Residenti,CONTESTUALE,5211,61059,66270
8,2023,Residenti,CONTRATTO CONVIVENZA,3,13,16
8,2023,Residenti,ESISTENZA IN VITA,90,1037,1127
8,2023,Residenti,MATRIMONIO,744,7646,8390
8,2023,Residenti,NASCITA,1163,11387,12550
8,2023,Residenti,RESIDENZA,3281,52766,56047
8,2023,Residenti,RESIDENZA IN CONVIVENZA,1,57,58
8,2023,Residenti,STATO CIVILE,692,6592,7284
8,2023,Residenti,STATO FAMIGLIA,3374,43465,46839
8,2023,Residenti,STATO FAMIGLIA CON RAPPORTI PARENTELA,503,7213,7716
8,2023,Residenti,STATO FAMIGLIA E STATO CIVILE,417,5584,6001
8,2023,Residenti,STATO LIBERO,768,2115,2883
8,2023,Residenti,UNIONE CIVILE ,10,49,59
9,2023,AIRE,CITTADINANZA,11,104,115
9,2023,AIRE,CONTESTUALE,89,434,523
9,2023,AIRE,ESISTENZA IN VITA,0,1,1
9,2023,AIRE,MATRIMONIO,30,184,214
9,2023,AIRE,NASCITA,134,280,414
9,2023,AIRE,RESIDENZA,123,516,639
9,2023,AIRE,STATO CIVILE,1,9,10
9,2023,AIRE,STATO FAMIGLIA,38,245,283
9,2023,AIRE,STATO FAMIGLIA CON RAPPORTI PARENTELA,0,8,8
9,2023,AIRE,STATO FAMIGLIA E STATO CIVILE,0,8,8
9,2023,AIRE,STATO LIBERO,4,7,11
9,2023,AIRE,UNIONE CIVILE ,1,0,1
9,2023,Residenti,CITTADINANZA,104,2185,2289
9,2023,Residenti,CONTESTUALE,9131,133618,142749
9,2023,Residenti,CONTRATTO CONVIVENZA,1,9,10
9,2023,Residenti,ESISTENZA IN VITA,148,1533,1681
9,2023,Residenti,MATRIMONIO,1601,13137,14738
9,2023,Residenti,NASCITA,1648,17421,19069
9,2023,Residenti,RESIDENZA,5169,73837,79006
9,2023,Residenti,RESIDENZA IN CONVIVENZA,2,76,78
9,2023,Residenti,STATO CIVILE,2008,12171,14179
9,2023,Residenti,STATO FAMIGLIA,5684,73280,78964
9,2023,Residenti,STATO FAMIGLIA CON RAPPORTI PARENTELA,721,10998,11719
9,2023,Residenti,STATO FAMIGLIA E STATO CIVILE,789,9027,9816
9,2023,Residenti,STATO LIBERO,1924,4388,6312
9,2023,Residenti,UNIONE CIVILE ,13,76,89
10,2023,AIRE,CITTADINANZA,6,105,111
10,2023,AIRE,CONTESTUALE,111,470,581
10,2023,AIRE,ESISTENZA IN VITA,0,3,3
10,2023,AIRE,MATRIMONIO,24,185,209
10,2023,AIRE,NASCITA,98,366,464
10,2023,AIRE,RESIDENZA,124,667,791
10,2023,AIRE,STATO CIVILE,2,11,13
10,2023,AIRE,STATO FAMIGLIA,36,256,292
10,2023,AIRE,STATO FAMIGLIA CON RAPPORTI PARENTELA,0,6,6
10,2023,AIRE,STATO FAMIGLIA E STATO CIVILE,0,4,4
10,2023,AIRE,STATO LIBERO,3,2,5
10,2023,AIRE,UNIONE CIVILE ,0,1,1
10,2023,Residenti,CITTADINANZA,127,2352,2479
10,2023,Residenti,CONTESTUALE,10174,103231,113405
10,2023,Residenti,CONTRATTO CONVIVENZA,3,16,19
10,2023,Residenti,ESISTENZA IN VITA,181,1815,1996
10,2023,Residenti,MATRIMONIO,1659,14723,16382
10,2023,Residenti,NASCITA,1522,16874,18396
10,2023,Residenti,RESIDENZA,5589,76236,81825
10,2023,Residenti,RESIDENZA IN CONVIVENZA,5,95,100
10,2023,Residenti,STATO CIVILE,2150,12690,14840
10,2023,Residenti,STATO FAMIGLIA,5661,68749,74410
10,2023,Residenti,STATO FAMIGLIA CON RAPPORTI PARENTELA,774,10952,11726
10,2023,Residenti,STATO FAMIGLIA E STATO CIVILE,905,9517,10422
10,2023,Residenti,STATO LIBERO,2132,4551,6683
10,2023,Residenti,UNIONE CIVILE ,9,73,82
11,2023,AIRE,CITTADINANZA,7,112,119
11,2023,AIRE,CONTESTUALE,102,463,565
11,2023,AIRE,MATRIMONIO,21,172,193
11,2023,AIRE,NASCITA,136,317,453
11,2023,AIRE,RESIDENZA,125,604,729
11,2023,AIRE,STATO CIVILE,3,6,9
11,2023,AIRE,STATO FAMIGLIA,28,245,273
11,2023,AIRE,STATO FAMIGLIA CON RAPPORTI PARENTELA,0,6,6
11,2023,AIRE,STATO FAMIGLIA E STATO CIVILE,1,0,1
11,2023,AIRE,STATO LIBERO,1,4,5
11,2023,Residenti,CITTADINANZA,92,1961,2053
11,2023,Residenti,CONTESTUALE,9612,69656,79268
11,2023,Residenti,CONTRATTO CONVIVENZA,1,10,11
11,2023,Residenti,ESISTENZA IN VITA,177,1817,1994
11,2023,Residenti,MATRIMONIO,1390,13324,14714
11,2023,Residenti,NASCITA,1436,14156,15592
11,2023,Residenti,RESIDENZA,4962,70238,75200
11,2023,Residenti,RESIDENZA IN CONVIVENZA,1,66,67
11,2023,Residenti,STATO CIVILE,2107,11997,14104
11,2023,Residenti,STATO FAMIGLIA,5478,60636,66114
11,2023,Residenti,STATO FAMIGLIA CON RAPPORTI PARENTELA,771,10650,11421
11,2023,Residenti,STATO FAMIGLIA E STATO CIVILE,817,8707,9524
11,2023,Residenti,STATO LIBERO,2406,4896,7302
11,2023,Residenti,UNIONE CIVILE ,21,69,90
12,2023,AIRE,CITTADINANZA,14,91,105
12,2023,AIRE,CONTESTUALE,110,454,564
12,2023,AIRE,ESISTENZA IN VITA,0,2,2
12,2023,AIRE,MATRIMONIO,25,154,179
12,2023,AIRE,NASCITA,106,296,402
12,2023,AIRE,RESIDENZA,88,614,702
12,2023,AIRE,STATO CIVILE,2,9,11
12,2023,AIRE,STATO FAMIGLIA,26,224,250
12,2023,AIRE,STATO FAMIGLIA CON RAPPORTI PARENTELA,0,8,8
12,2023,AIRE,STATO FAMIGLIA E STATO CIVILE,0,4,4
12,2023,AIRE,STATO LIBERO,2,3,5
12,2023,AIRE,UNIONE CIVILE ,1,0,1
12,2023,Residenti,CITTADINANZA,97,1831,1928
12,2023,Residenti,CONTESTUALE,7666,60101,67767
12,2023,Residenti,CONTRATTO CONVIVENZA,2,10,12
12,2023,Residenti,ESISTENZA IN VITA,166,2268,2434
12,2023,Residenti,MATRIMONIO,996,10982,11978
12,2023,Residenti,NASCITA,1242,12127,13369
12,2023,Residenti,RESIDENZA,4304,125692,129996
12,2023,Residenti,RESIDENZA IN CONVIVENZA,1,68,69
12,2023,Residenti,STATO CIVILE,1615,10020,11635
12,2023,Residenti,STATO FAMIGLIA,4537,50142,54679
12,2023,Residenti,STATO FAMIGLIA CON RAPPORTI PARENTELA,715,8128,8843
12,2023,Residenti,STATO FAMIGLIA E STATO CIVILE,647,6561,7208
12,2023,Residenti,STATO LIBERO,1699,3720,5419
12,2023,Residenti,UNIONE CIVILE ,8,52,60
1,2024,AIRE,CITTADINANZA,15,101,116
1,2024,AIRE,CONTESTUALE,123,568,691
1,2024,AIRE,MATRIMONIO,32,183,215
1,2024,AIRE,NASCITA,187,369,556
1,2024,AIRE,RESIDENZA,146,900,1046
1,2024,AIRE,STATO CIVILE,3,10,13
1,2024,AIRE,STATO FAMIGLIA,33,289,322
1,2024,AIRE,STATO FAMIGLIA CON RAPPORTI PARENTELA,1,6,7
1,2024,AIRE,STATO FAMIGLIA E STATO CIVILE,0,3,3
1,2024,AIRE,STATO LIBERO,4,12,16
1,2024,AIRE,UNIONE CIVILE ,0,2,2
1,2024,Residenti,CITTADINANZA,137,2729,2866
1,2024,Residenti,CONTESTUALE,11913,109164,121077
1,2024,Residenti,CONTRATTO CONVIVENZA,1,23,24
1,2024,Residenti,ESISTENZA IN VITA,211,4536,4747
1,2024,Residenti,MATRIMONIO,1366,17050,18416
1,2024,Residenti,NASCITA,1840,19403,21243
1,2024,Residenti,RESIDENZA,6058,245159,251217
1,2024,Residenti,RESIDENZA IN CONVIVENZA,0,172,172
1,2024,Residenti,STATO CIVILE,2071,16078,18149
1,2024,Residenti,STATO FAMIGLIA,7781,110347,118128
1,2024,Residenti,STATO FAMIGLIA CON RAPPORTI PARENTELA,1118,14376,15494
1,2024,Residenti,STATO FAMIGLIA E STATO CIVILE,1009,11884,12893
1,2024,Residenti,STATO LIBERO,2250,5134,7384
1,2024,Residenti,UNIONE CIVILE ,11,81,92
2,2024,AIRE,CITTADINANZA,13,145,158
2,2024,AIRE,CONTESTUALE,138,511,649
2,2024,AIRE,ESISTENZA IN VITA,0,2,2
2,2024,AIRE,MATRIMONIO,32,168,200
2,2024,AIRE,NASCITA,185,418,603
2,2024,AIRE,RESIDENZA,140,1051,1191
2,2024,AIRE,STATO CIVILE,4,18,22
2,2024,AIRE,STATO FAMIGLIA,23,301,324
2,2024,AIRE,STATO FAMIGLIA CON RAPPORTI PARENTELA,1,10,11
2,2024,AIRE,STATO FAMIGLIA E STATO CIVILE,0,8,8
2,2024,AIRE,STATO LIBERO,2,6,8
2,2024,AIRE,UNIONE CIVILE ,1,2,3
2,2024,Residenti,CITTADINANZA,121,2777,2898
2,2024,Residenti,CONTESTUALE,13360,118349,131709
2,2024,Residenti,CONTRATTO CONVIVENZA,3,20,23
2,2024,Residenti,ESISTENZA IN VITA,181,3888,4069
2,2024,Residenti,MATRIMONIO,1277,18832,20109
2,2024,Residenti,NASCITA,1750,19834,21584
2,2024,Residenti,RESIDENZA,5831,270546,276377
2,2024,Residenti,RESIDENZA IN CONVIVENZA,4,212,216
2,2024,Residenti,STATO CIVILE,2149,17126,19275
2,2024,Residenti,STATO FAMIGLIA,7077,92596,99673
2,2024,Residenti,STATO FAMIGLIA CON RAPPORTI PARENTELA,861,11627,12488
2,2024,Residenti,STATO FAMIGLIA E STATO CIVILE,1039,10538,11577
2,2024,Residenti,STATO LIBERO,2396,5528,7924
2,2024,Residenti,UNIONE CIVILE ,10,90,100
3,2024,AIRE,CITTADINANZA,9,112,121
3,2024,AIRE,CONTESTUALE,145,614,759
3,2024,AIRE,ESISTENZA IN VITA,0,1,1
3,2024,AIRE,GODIMENTO DEI DIRITTI POLITICI,0,9,9
3,2024,AIRE,ISCRIZIONE NELLE LISTE ELETTORALI,2,13,15
3,2024,AIRE,MATRIMONIO,23,198,221
3,2024,AIRE,NASCITA,182,456,638
3,2024,AIRE,RESIDENZA,163,1143,1306
3,2024,AIRE,STATO CIVILE,4,13,17
3,2024,AIRE,STATO FAMIGLIA,27,298,325
3,2024,AIRE,STATO FAMIGLIA CON RAPPORTI PARENTELA,1,3,4
3,2024,AIRE,STATO FAMIGLIA E STATO CIVILE,1,11,12
3,2024,AIRE,STATO LIBERO,5,7,12
3,2024,AIRE,UNIONE CIVILE ,1,5,6
3,2024,Residenti,CITTADINANZA,163,2819,2982
3,2024,Residenti,CONTESTUALE,17102,124832,141934
3,2024,Residenti,CONTRATTO CONVIVENZA,4,16,20
3,2024,Residenti,ESISTENZA IN VITA,182,3352,3534
3,2024,Residenti,GODIMENTO DEI DIRITTI POLITICI,53,281,334
3,2024,Residenti,ISCRIZIONE NELLE LISTE ELETTORALI,15,800,815
3,2024,Residenti,MATRIMONIO,1351,18001,19352
3,2024,Residenti,NASCITA,1710,19334,21044
3,2024,Residenti,RESIDENZA,6089,268382,274471
3,2024,Residenti,RESIDENZA IN CONVIVENZA,4,223,227
3,2024,Residenti,STATO CIVILE,2132,16832,18964
3,2024,Residenti,STATO FAMIGLIA,6719,84528,91247
3,2024,Residenti,STATO FAMIGLIA CON RAPPORTI PARENTELA,860,10379,11239
3,2024,Residenti,STATO FAMIGLIA E STATO CIVILE,989,9528,10517
3,2024,Residenti,STATO LIBERO,2453,5509,7962
3,2024,Residenti,UNIONE CIVILE ,7,90,97
4,2024,AIRE,CITTADINANZA,18,135,153
4,2024,AIRE,CONTESTUALE,151,615,766
4,2024,AIRE,ESISTENZA IN VITA,0,2,2
4,2024,AIRE,GODIMENTO DEI DIRITTI POLITICI,2,10,12
4,2024,AIRE,ISCRIZIONE NELLE LISTE ELETTORALI,3,16,19
4,2024,AIRE,MATRIMONIO,30,171,201
4,2024,AIRE,NASCITA,155,426,581
4,2024,AIRE,RESIDENZA,198,1117,1315
4,2024,AIRE,STATO CIVILE,4,9,13
4,2024,AIRE,STATO FAMIGLIA,42,277,319
4,2024,AIRE,STATO FAMIGLIA CON RAPPORTI PARENTELA,0,6,6
4,2024,AIRE,STATO FAMIGLIA E STATO CIVILE,0,13,13
4,2024,AIRE,STATO LIBERO,1,4,5
4,2024,AIRE,UNIONE CIVILE ,1,0,1
4,2024,Residenti,CITTADINANZA,118,2803,2921
4,2024,Residenti,CONTESTUALE,13866,117412,131278
4,2024,Residenti,CONTRATTO CONVIVENZA,3,16,19
4,2024,Residenti,ESISTENZA IN VITA,170,3140,3310
4,2024,Residenti,GODIMENTO DEI DIRITTI POLITICI,66,785,851
4,2024,Residenti,ISCRIZIONE NELLE LISTE ELETTORALI,110,7679,7789
4,2024,Residenti,MATRIMONIO,1310,17756,19066
4,2024,Residenti,NASCITA,1812,18596,20408
4,2024,Residenti,RESIDENZA,5750,258625,264375
4,2024,Residenti,RESIDENZA IN CONVIVENZA,2,210,212
4,2024,Residenti,STATO CIVILE,2179,16396,18575
4,2024,Residenti,STATO FAMIGLIA,6335,79227,85562
4,2024,Residenti,STATO FAMIGLIA CON RAPPORTI PARENTELA,814,9542,10356
4,2024,Residenti,STATO FAMIGLIA E STATO CIVILE,937,9147,10084
4,2024,Residenti,STATO LIBERO,2564,5449,8013
4,2024,Residenti,UNIONE CIVILE ,15,78,93
5,2024,AIRE,CITTADINANZA,17,113,130
5,2024,AIRE,CONTESTUALE,135,682,817
5,2024,AIRE,ESISTENZA IN VITA,0,3,3
5,2024,AIRE,GODIMENTO DEI DIRITTI POLITICI,1,9,10
5,2024,AIRE,ISCRIZIONE NELLE LISTE ELETTORALI,4,57,61
5,2024,AIRE,MATRIMONIO,29,213,242
5,2024,AIRE,NASCITA,149,385,534
5,2024,AIRE,RESIDENZA,162,1131,1293
5,2024,AIRE,STATO CIVILE,5,21,26
5,2024,AIRE,STATO FAMIGLIA,47,297,344
5,2024,AIRE,STATO FAMIGLIA CON RAPPORTI PARENTELA,0,2,2
5,2024,AIRE,STATO FAMIGLIA E STATO CIVILE,1,3,4
5,2024,AIRE,STATO LIBERO,1,3,4
5,2024,AIRE,UNIONE CIVILE ,2,5,7
5,2024,Residenti,CITTADINANZA,120,3183,3303
5,2024,Residenti,CONTESTUALE,14824,134246,149070
5,2024,Residenti,CONTRATTO CONVIVENZA,4,21,25
5,2024,Residenti,ESISTENZA IN VITA,194,3582,3776
5,2024,Residenti,GODIMENTO DEI DIRITTI POLITICI,101,1183,1284
5,2024,Residenti,ISCRIZIONE NELLE LISTE ELETTORALI,95,7998,8093
5,2024,Residenti,MATRIMONIO,1743,20566,22309
5,2024,Residenti,NASCITA,1831,21905,23736
5,2024,Residenti,RESIDENZA,6094,297225,303319
5,2024,Residenti,RESIDENZA IN CONVIVENZA,4,174,178
5,2024,Residenti,STATO CIVILE,2701,19604,22305
5,2024,Residenti,STATO FAMIGLIA,7245,90477,97722
5,2024,Residenti,STATO FAMIGLIA CON RAPPORTI PARENTELA,969,11061,12030
5,2024,Residenti,STATO FAMIGLIA E STATO CIVILE,1099,9916,11015
5,2024,Residenti,STATO LIBERO,2891,6633,9524
5,2024,Residenti,UNIONE CIVILE ,13,87,100
6,2024,AIRE,CITTADINANZA,13,106,119
6,2024,AIRE,CONTESTUALE,123,637,760
6,2024,AIRE,ESISTENZA IN VITA,0,6,6
6,2024,AIRE,GODIMENTO DEI DIRITTI POLITICI,0,5,5
6,2024,AIRE,ISCRIZIONE NELLE LISTE ELETTORALI,2,70,72
6,2024,AIRE,MATRIMONIO,42,178,220
6,2024,AIRE,NASCITA,173,354,527
6,2024,AIRE,RESIDENZA,169,926,1095
6,2024,AIRE,STATO CIVILE,2,11,13
6,2024,AIRE,STATO FAMIGLIA,44,310,354
6,2024,AIRE,STATO FAMIGLIA CON RAPPORTI PARENTELA,1,6,7
6,2024,AIRE,STATO FAMIGLIA E STATO CIVILE,1,5,6
6,2024,AIRE,STATO LIBERO,2,3,5
6,2024,AIRE,UNIONE CIVILE ,0,3,3
6,2024,Residenti,CITTADINANZA,136,2701,2837
6,2024,Residenti,CONTESTUALE,11538,117563,129101
6,2024,Residenti,CONTRATTO CONVIVENZA,1,20,21
6,2024,Residenti,ESISTENZA IN VITA,172,3300,3472
6,2024,Residenti,GODIMENTO DEI DIRITTI POLITICI,95,1145,1240
6,2024,Residenti,ISCRIZIONE NELLE LISTE ELETTORALI,27,2017,2044
6,2024,Residenti,MATRIMONIO,1786,18122,19908
6,2024,Residenti,NASCITA,1683,17364,19047
6,2024,Residenti,RESIDENZA,5446,262524,267970
6,2024,Residenti,RESIDENZA IN CONVIVENZA,1,163,164
6,2024,Residenti,STATO CIVILE,2314,17578,19892
6,2024,Residenti,STATO FAMIGLIA,6589,78712,85301
6,2024,Residenti,STATO FAMIGLIA CON RAPPORTI PARENTELA,838,9247,10085
6,2024,Residenti,STATO FAMIGLIA E STATO CIVILE,979,8506,9485
6,2024,Residenti,STATO LIBERO,2442,5776,8218
6,2024,Residenti,UNIONE CIVILE ,19,79,98
7,2024,AIRE,CITTADINANZA,13,124,137
7,2024,AIRE,CONTESTUALE,112,586,698
7,2024,AIRE,ESISTENZA IN VITA,0,2,2
7,2024,AIRE,GODIMENTO DEI DIRITTI POLITICI,1,6,7
7,2024,AIRE,ISCRIZIONE NELLE LISTE ELETTORALI,0,7,7
7,2024,AIRE,MATRIMONIO,38,165,203
7,2024,AIRE,NASCITA,186,351,537
7,2024,AIRE,RESIDENZA,187,1065,1252
7,2024,AIRE,STATO CIVILE,9,10,19
7,2024,AIRE,STATO FAMIGLIA,51,321,372
7,2024,AIRE,STATO FAMIGLIA CON RAPPORTI PARENTELA,1,2,3
7,2024,AIRE,STATO FAMIGLIA E STATO CIVILE,0,1,1
7,2024,AIRE,STATO LIBERO,0,6,6
7,2024,AIRE,UNIONE CIVILE ,0,1,1
7,2024,Residenti,CITTADINANZA,142,2926,3068
7,2024,Residenti,CONTESTUALE,12094,151205,163299
7,2024,Residenti,CONTRATTO CONVIVENZA,3,23,26
7,2024,Residenti,ESISTENZA IN VITA,169,3623,3792
7,2024,Residenti,GODIMENTO DEI DIRITTI POLITICI,118,243,361
7,2024,Residenti,ISCRIZIONE NELLE LISTE ELETTORALI,24,211,235
7,2024,Residenti,MATRIMONIO,1889,19847,21736
7,2024,Residenti,NASCITA,1816,19102,20918
7,2024,Residenti,RESIDENZA,6205,286837,293042
7,2024,Residenti,RESIDENZA IN CONVIVENZA,5,186,191
7,2024,Residenti,STATO CIVILE,2371,18413,20784
7,2024,Residenti,STATO FAMIGLIA,7049,88644,95693
7,2024,Residenti,STATO FAMIGLIA CON RAPPORTI PARENTELA,989,10302,11291
7,2024,Residenti,STATO FAMIGLIA E STATO CIVILE,1084,8992,10076
7,2024,Residenti,STATO LIBERO,2570,5937,8507
7,2024,Residenti,UNIONE CIVILE ,23,77,100
8,2024,AIRE,CITTADINANZA,29,92,121
8,2024,AIRE,CONTESTUALE,93,429,522
8,2024,AIRE,GODIMENTO DEI DIRITTI POLITICI,1,5,6
8,2024,AIRE,ISCRIZIONE NELLE LISTE ELETTORALI,0,5,5
8,2024,AIRE,MATRIMONIO,24,162,186
8,2024,AIRE,NASCITA,180,355,535
8,2024,AIRE,RESIDENZA,126,720,846
8,2024,AIRE,STATO CIVILE,1,9,10
8,2024,AIRE,STATO FAMIGLIA,41,230,271
8,2024,AIRE,STATO FAMIGLIA E STATO CIVILE,0,2,2
8,2024,AIRE,STATO LIBERO,1,2,3
8,2024,AIRE,UNIONE CIVILE ,1,1,2
8,2024,Residenti,CITTADINANZA,113,2053,2166
8,2024,Residenti,CONTESTUALE,6952,83187,90139
8,2024,Residenti,CONTRATTO CONVIVENZA,2,15,17
8,2024,Residenti,ESISTENZA IN VITA,101,1723,1824
8,2024,Residenti,GODIMENTO DEI DIRITTI POLITICI,56,166,222
8,2024,Residenti,ISCRIZIONE NELLE LISTE ELETTORALI,22,299,321
8,2024,Residenti,MATRIMONIO,929,9353,10282
8,2024,Residenti,NASCITA,1453,12723,14176
8,2024,Residenti,RESIDENZA,4393,134666,139059
8,2024,Residenti,RESIDENZA IN CONVIVENZA,2,84,86
8,2024,Residenti,STATO CIVILE,864,8468,9332
8,2024,Residenti,STATO FAMIGLIA,4255,52966,57221
8,2024,Residenti,STATO FAMIGLIA CON RAPPORTI PARENTELA,636,6843,7479
8,2024,Residenti,STATO FAMIGLIA E STATO CIVILE,559,5339,5898
8,2024,Residenti,STATO LIBERO,942,2294,3236
8,2024,Residenti,UNIONE CIVILE ,9,55,64
9,2024,AIRE,CITTADINANZA,16,127,143
9,2024,AIRE,CONTESTUALE,131,591,722
9,2024,AIRE,ESISTENZA IN VITA,0,1,1
9,2024,AIRE,GODIMENTO DEI DIRITTI POLITICI,1,1,2
9,2024,AIRE,ISCRIZIONE NELLE LISTE ELETTORALI,1,11,12
9,2024,AIRE,MATRIMONIO,53,211,264
9,2024,AIRE,NASCITA,182,443,625
9,2024,AIRE,RESIDENZA,166,1011,1177
9,2024,AIRE,STATO CIVILE,2,14,16
9,2024,AIRE,STATO FAMIGLIA,44,318,362
9,2024,AIRE,STATO FAMIGLIA CON RAPPORTI PARENTELA,0,4,4
9,2024,AIRE,STATO FAMIGLIA E STATO CIVILE,0,5,5
9,2024,AIRE,STATO LIBERO,3,4,7
9,2024,AIRE,UNIONE CIVILE ,3,0,3
9,2024,Residenti,CITTADINANZA,150,3362,3512
9,2024,Residenti,CONTESTUALE,13061,203344,216405
9,2024,Residenti,CONTRATTO CONVIVENZA,5,20,25
9,2024,Residenti,ESISTENZA IN VITA,199,3430,3629
9,2024,Residenti,GODIMENTO DEI DIRITTI POLITICI,82,279,361
9,2024,Residenti,ISCRIZIONE NELLE LISTE ELETTORALI,15,335,350
9,2024,Residenti,MATRIMONIO,1932,19849,21781
9,2024,Residenti,NASCITA,1911,21813,23724
9,2024,Residenti,RESIDENZA,6333,293429,299762
9,2024,Residenti,RESIDENZA IN CONVIVENZA,3,217,220
9,2024,Residenti,STATO CIVILE,2553,18714,21267
9,2024,Residenti,STATO FAMIGLIA,7300,104360,111660
9,2024,Residenti,STATO FAMIGLIA CON RAPPORTI PARENTELA,953,11811,12764
9,2024,Residenti,STATO FAMIGLIA E STATO CIVILE,1014,9862,10876
9,2024,Residenti,STATO LIBERO,2629,6039,8668
9,2024,Residenti,UNIONE CIVILE ,20,93,113
10,2024,AIRE,CITTADINANZA,18,101,119
10,2024,AIRE,CONTESTUALE,139,653,792
10,2024,AIRE,ESISTENZA IN VITA,0,2,2
10,2024,AIRE,GODIMENTO DEI DIRITTI POLITICI,0,1,1
10,2024,AIRE,ISCRIZIONE NELLE LISTE ELETTORALI,0,6,6
10,2024,AIRE,MATRIMONIO,41,222,263
10,2024,AIRE,NASCITA,203,457,660
10,2024,AIRE,RESIDENZA,220,1272,1492
10,2024,AIRE,STATO CIVILE,7,7,14
10,2024,AIRE,STATO FAMIGLIA,40,329,369
10,2024,AIRE,STATO FAMIGLIA CON RAPPORTI PARENTELA,0,5,5
10,2024,AIRE,STATO FAMIGLIA E STATO CIVILE,0,1,1
10,2024,AIRE,STATO LIBERO,2,5,7
10,2024,AIRE,UNIONE CIVILE ,0,1,1
10,2024,Residenti,CITTADINANZA,169,3617,3786
10,2024,Residenti,CONTESTUALE,15396,190905,206301
10,2024,Residenti,CONTRATTO CONVIVENZA,0,23,23
10,2024,Residenti,ESISTENZA IN VITA,256,4050,4306
10,2024,Residenti,GODIMENTO DEI DIRITTI POLITICI,54,264,318
10,2024,Residenti,ISCRIZIONE NELLE LISTE ELETTORALI,16,657,673
10,2024,Residenti,MATRIMONIO,2284,23426,25710
10,2024,Residenti,NASCITA,1826,22452,24278
10,2024,Residenti,RESIDENZA,7434,335683,343117
10,2024,Residenti,RESIDENZA IN CONVIVENZA,5,229,234
10,2024,Residenti,STATO CIVILE,2857,21566,24423
10,2024,Residenti,STATO FAMIGLIA,8318,105133,113451
10,2024,Residenti,STATO FAMIGLIA CON RAPPORTI PARENTELA,1055,11963,13018
10,2024,Residenti,STATO FAMIGLIA E STATO CIVILE,1287,10683,11970
10,2024,Residenti,STATO LIBERO,3100,6742,9842
10,2024,Residenti,UNIONE CIVILE ,21,110,131
11,2024,AIRE,CITTADINANZA,28,102,130
11,2024,AIRE,CONTESTUALE,151,609,760
11,2024,AIRE,ESISTENZA IN VITA,0,2,2
11,2024,AIRE,GODIMENTO DEI DIRITTI POLITICI,0,8,8
11,2024,AIRE,ISCRIZIONE NELLE LISTE ELETTORALI,0,3,3
11,2024,AIRE,MATRIMONIO,53,212,265
11,2024,AIRE,NASCITA,204,446,650
11,2024,AIRE,RESIDENZA,157,1151,1308
11,2024,AIRE,STATO CIVILE,4,5,9
11,2024,AIRE,STATO FAMIGLIA,53,301,354
11,2024,AIRE,STATO FAMIGLIA CON RAPPORTI PARENTELA,0,5,5
11,2024,AIRE,STATO FAMIGLIA E STATO CIVILE,3,4,7
11,2024,AIRE,STATO LIBERO,0,6,6
11,2024,AIRE,UNIONE CIVILE ,1,2,3
11,2024,Residenti,CITTADINANZA,107,3166,3273
11,2024,Residenti,CONTESTUALE,12787,144202,156989
11,2024,Residenti,CONTRATTO CONVIVENZA,2,19,21
11,2024,Residenti,ESISTENZA IN VITA,188,3337,3525
11,2024,Residenti,GODIMENTO DEI DIRITTI POLITICI,118,225,343
11,2024,Residenti,ISCRIZIONE NELLE LISTE ELETTORALI,15,259,274
11,2024,Residenti,MATRIMONIO,1633,19647,21280
11,2024,Residenti,NASCITA,1608,18978,20586
11,2024,Residenti,RESIDENZA,6220,300840,307060
11,2024,Residenti,RESIDENZA IN CONVIVENZA,5,221,226
11,2024,Residenti,STATO CIVILE,2778,19028,21806
11,2024,Residenti,STATO FAMIGLIA,6527,89322,95849
11,2024,Residenti,STATO FAMIGLIA CON RAPPORTI PARENTELA,828,11126,11954
11,2024,Residenti,STATO FAMIGLIA E STATO CIVILE,1005,9345,10350
11,2024,Residenti,STATO LIBERO,3013,6505,9518
11,2024,Residenti,UNIONE CIVILE ,19,85,104
12,2024,AIRE,CITTADINANZA,15,126,141
12,2024,AIRE,CONTESTUALE,107,566,673
12,2024,AIRE,ESISTENZA IN VITA,0,2,2
12,2024,AIRE,GODIMENTO DEI DIRITTI POLITICI,2,5,7
12,2024,AIRE,ISCRIZIONE NELLE LISTE ELETTORALI,0,7,7
12,2024,AIRE,MATRIMONIO,38,187,225
12,2024,AIRE,NASCITA,170,370,540
12,2024,AIRE,RESIDENZA,164,1173,1337
12,2024,AIRE,STATO CIVILE,4,10,14
12,2024,AIRE,STATO FAMIGLIA,48,301,349
12,2024,AIRE,STATO FAMIGLIA CON RAPPORTI PARENTELA,0,1,1
12,2024,AIRE,STATO FAMIGLIA E STATO CIVILE,0,2,2
12,2024,AIRE,STATO LIBERO,1,0,1
12,2024,AIRE,UNIONE CIVILE ,1,0,1
12,2024,Residenti,CITTADINANZA,99,2875,2974
12,2024,Residenti,CONTESTUALE,9694,108696,118390
12,2024,Residenti,CONTRATTO CONVIVENZA,4,17,21
12,2024,Residenti,ESISTENZA IN VITA,168,2956,3124
12,2024,Residenti,GODIMENTO DEI DIRITTI POLITICI,67,180,247
12,2024,Residenti,ISCRIZIONE NELLE LISTE ELETTORALI,11,167,178
12,2024,Residenti,MATRIMONIO,1266,15343,16609
12,2024,Residenti,NASCITA,1510,15793,17303
12,2024,Residenti,RESIDENZA,5265,241619,246884
12,2024,Residenti,RESIDENZA IN CONVIVENZA,2,146,148
12,2024,Residenti,STATO CIVILE,2064,14474,16538
12,2024,Residenti,STATO FAMIGLIA,5615,69288,74903
12,2024,Residenti,STATO FAMIGLIA CON RAPPORTI PARENTELA,829,8685,9514
12,2024,Residenti,STATO FAMIGLIA E STATO CIVILE,846,7281,8127
12,2024,Residenti,STATO LIBERO,2202,4507,6709
12,2024,Residenti,UNIONE CIVILE ,9,71,80
1,2025,AIRE,CITTADINANZA,28,137,165
1,2025,AIRE,CONTESTUALE,166,658,824
1,2025,AIRE,ESISTENZA IN VITA,0,3,3
1,2025,AIRE,GODIMENTO DEI DIRITTI POLITICI,0,6,6
1,2025,AIRE,ISCRIZIONE NELLE LISTE ELETTORALI,2,8,10
1,2025,AIRE,MATRIMONIO,39,228,267
1,2025,AIRE,NASCITA,260,487,747
1,2025,AIRE,RESIDENZA,162,1286,1448
1,2025,AIRE,STATO CIVILE,4,10,14
1,2025,AIRE,STATO FAMIGLIA,61,351,412
1,2025,AIRE,STATO FAMIGLIA CON RAPPORTI PARENTELA,0,1,1
1,2025,AIRE,STATO FAMIGLIA E STATO CIVILE,6,8,14
1,2025,AIRE,STATO LIBERO,2,4,6
1,2025,AIRE,UNIONE CIVILE ,2,5,7
1,2025,Residenti,CITTADINANZA,161,3439,3600
1,2025,Residenti,CONTESTUALE,16362,159002,175364
1,2025,Residenti,CONTRATTO CONVIVENZA,7,33,40
1,2025,Residenti,ESISTENZA IN VITA,264,4479,4743
1,2025,Residenti,GODIMENTO DEI DIRITTI POLITICI,83,390,473
1,2025,Residenti,ISCRIZIONE NELLE LISTE ELETTORALI,10,296,306
1,2025,Residenti,MATRIMONIO,1810,20350,22160
1,2025,Residenti,NASCITA,2301,21444,23745
1,2025,Residenti,RESIDENZA,8084,322785,330869
1,2025,Residenti,RESIDENZA IN CONVIVENZA,7,335,342
1,2025,Residenti,STATO CIVILE,3207,20789,23996
1,2025,Residenti,STATO FAMIGLIA,9172,125790,134962
1,2025,Residenti,STATO FAMIGLIA CON RAPPORTI PARENTELA,1149,15629,16778
1,2025,Residenti,STATO FAMIGLIA E STATO CIVILE,1396,13408,14804
1,2025,Residenti,STATO LIBERO,3202,6389,9591
1,2025,Residenti,UNIONE CIVILE ,10,82,92
2,2025,AIRE,CITTADINANZA,16,114,130
2,2025,AIRE,CONTESTUALE,152,615,767
2,2025,AIRE,ESISTENZA IN VITA,0,3,3
2,2025,AIRE,GODIMENTO DEI DIRITTI POLITICI,2,2,4
2,2025,AIRE,ISCRIZIONE NELLE LISTE ELETTORALI,2,6,8
2,2025,AIRE,MATRIMONIO,42,187,229
2,2025,AIRE,NASCITA,293,424,717
2,2025,AIRE,RESIDENZA,189,1164,1353
2,2025,AIRE,STATO CIVILE,2,9,11
2,2025,AIRE,STATO FAMIGLIA,53,309,362
2,2025,AIRE,STATO FAMIGLIA CON RAPPORTI PARENTELA,1,2,3
2,2025,AIRE,STATO FAMIGLIA E STATO CIVILE,0,2,2
2,2025,AIRE,STATO LIBERO,2,1,3
2,2025,AIRE,UNIONE CIVILE ,2,1,3
2,2025,Residenti,CITTADINANZA,133,2931,3064
2,2025,Residenti,CONTESTUALE,16694,144845,161539
2,2025,Residenti,CONTRATTO CONVIVENZA,3,28,31
2,2025,Residenti,ESISTENZA IN VITA,219,3524,3743
2,2025,Residenti,GODIMENTO DEI DIRITTI POLITICI,89,258,347
2,2025,Residenti,ISCRIZIONE NELLE LISTE ELETTORALI,23,613,636
2,2025,Residenti,MATRIMONIO,1687,18115,19802
2,2025,Residenti,NASCITA,2166,18035,20201
2,2025,Residenti,RESIDENZA,7582,304509,312091
2,2025,Residenti,RESIDENZA IN CONVIVENZA,7,238,245
2,2025,Residenti,STATO CIVILE,2939,17143,20082
2,2025,Residenti,STATO FAMIGLIA,8787,88232,97019
2,2025,Residenti,STATO FAMIGLIA CON RAPPORTI PARENTELA,947,10293,11240
2,2025,Residenti,STATO FAMIGLIA E STATO CIVILE,1170,8728,9898
2,2025,Residenti,STATO LIBERO,2969,5068,8037
2,2025,Residenti,UNIONE CIVILE ,16,68,84
3,2025,AIRE,CITTADINANZA,24,110,134
3,2025,AIRE,CONTESTUALE,201,613,814
3,2025,AIRE,GODIMENTO DEI DIRITTI POLITICI,2,7,9
3,2025,AIRE,ISCRIZIONE NELLE LISTE ELETTORALI,0,14,14
3,2025,AIRE,MATRIMONIO,52,242,294
3,2025,AIRE,NASCITA,379,460,839
3,2025,AIRE,RESIDENZA,229,1089,1318
3,2025,AIRE,STATO CIVILE,2,9,11
3,2025,AIRE,STATO FAMIGLIA,54,358,412
3,2025,AIRE,STATO FAMIGLIA CON RAPPORTI PARENTELA,0,7,7
3,2025,AIRE,STATO LIBERO,2,2,4
3,2025,AIRE,UNIONE CIVILE ,0,3,3
3,2025,Residenti,CITTADINANZA,161,2931,3092
3,2025,Residenti,CONTESTUALE,18945,154009,172954
3,2025,Residenti,CONTRATTO CONVIVENZA,5,19,24
3,2025,Residenti,ESISTENZA IN VITA,253,3139,3392
3,2025,Residenti,GODIMENTO DEI DIRITTI POLITICI,95,294,389
3,2025,Residenti,ISCRIZIONE NELLE LISTE ELETTORALI,50,1196,1246
3,2025,Residenti,MATRIMONIO,1958,18170,20128
3,2025,Residenti,NASCITA,2467,17906,20373
3,2025,Residenti,RESIDENZA,8835,324094,332929
3,2025,Residenti,RESIDENZA IN CONVIVENZA,3,233,236
3,2025,Residenti,STATO CIVILE,3733,17334,21067
3,2025,Residenti,STATO FAMIGLIA,9541,83543,93084
3,2025,Residenti,STATO FAMIGLIA CON RAPPORTI PARENTELA,936,9110,10046
3,2025,Residenti,STATO FAMIGLIA E STATO CIVILE,1181,7895,9076
3,2025,Residenti,STATO LIBERO,3580,5428,9008
3,2025,Residenti,UNIONE CIVILE ,13,73,86
4,2025,AIRE,CITTADINANZA,32,141,173
4,2025,AIRE,CONTESTUALE,159,675,834
4,2025,AIRE,ESISTENZA IN VITA,0,1,1
4,2025,AIRE,GODIMENTO DEI DIRITTI POLITICI,3,6,9
4,2025,AIRE,ISCRIZIONE NELLE LISTE ELETTORALI,3,20,23
4,2025,AIRE,MATRIMONIO,53,203,256
4,2025,AIRE,NASCITA,325,393,718
4,2025,AIRE,RESIDENZA,242,1014,1256
4,2025,AIRE,STATO CIVILE,1,5,6
4,2025,AIRE,STATO FAMIGLIA,51,352,403
4,2025,AIRE,STATO FAMIGLIA CON RAPPORTI PARENTELA,0,2,2
4,2025,AIRE,STATO FAMIGLIA E STATO CIVILE,0,1,1
4,2025,AIRE,STATO LIBERO,1,1,2
4,2025,AIRE,UNIONE CIVILE ,0,2,2
4,2025,Residenti,CITTADINANZA,153,2704,2857
4,2025,Residenti,CONTESTUALE,16335,135904,152239
4,2025,Residenti,CONTRATTO CONVIVENZA,2,20,22
4,2025,Residenti,ESISTENZA IN VITA,213,2700,2913
4,2025,Residenti,GODIMENTO DEI DIRITTI POLITICI,87,514,601
4,2025,Residenti,ISCRIZIONE NELLE LISTE ELETTORALI,92,2053,2145
4,2025,Residenti,MATRIMONIO,1844,16268,18112
4,2025,Residenti,NASCITA,2463,16930,19393
4,2025,Residenti,RESIDENZA,7982,288984,296966
4,2025,Residenti,RESIDENZA IN CONVIVENZA,2,193,195
4,2025,Residenti,STATO CIVILE,3335,15327,18662
4,2025,Residenti,STATO FAMIGLIA,8751,73221,81972
4,2025,Residenti,STATO FAMIGLIA CON RAPPORTI PARENTELA,818,8098,8916
4,2025,Residenti,STATO FAMIGLIA E STATO CIVILE,1025,6866,7891
4,2025,Residenti,STATO LIBERO,3356,4624,7980
4,2025,Residenti,UNIONE CIVILE ,12,84,96